"A-Jay"	[5, ["Fergal", "Kaine", "Vince", "Barkley", "Deryn"]]
"AJ"	[3, ["John", "Warren", "Danys"]]
"Aaran"	[5, ["Leylann", "Gurardass", "Jamaal", "Conar", "Rubin"]]
"Aaren"	[3, ["Kristofer", "Hosea", "Daniil"]]
"Aarez"	[4, ["Zaine", "Tieran", "Gordon", "Roshan"]]
"Aarman"	[1, ["Stefin"]]
"Aaron"	[4, ["Santiago", "Abel", "Keenan-Lee", "Lyle"]]
"Aaron-James"	[4, ["Alexzander", "Roger", "Yves", "Sohaib"]]
"Aarron"	[4, ["Justinas", "Ewan", "Crispin", "Abdihakim"]]
"Aaryan"	[2, ["Dugald", "Yannick"]]
"Aaryn"	[3, ["Joshiah", "Albert", "Roary"]]
"Aayan"	[3, ["Raphael", "Mikee", "Domanic"]]
"Aazaan"	[4, ["Ainslie", "Francis", "Ihtisham", "Kyral"]]
"Abaan"	[5, ["Shaun-Thomas", "Bully", "Torin", "Darrius", "Jonothan"]]
"Abbas"	[4, ["Connall", "Benjamin", "Oluwafikunayomi", "Jardine"]]
"Abdallah"	[5, ["Mahdi", "Dara", "Hussain", "Sergio", "Wasif"]]
"Abdalroof"	[3, ["Alvern", "Broghan", "TJ"]]
"Abdihakim"	[4, ["Oilibhear", "Hirvaansh", "Desmond", "Kairn"]]
"Abdirahman"	[3, ["Eduards", "Adam", "Brannan"]]
"Abdisalam"	[5, ["Jacques", "Soul", "Kadyn", "Masood", "Ronin"]]
"Abdul"	[4, ["Abdul-Majeed", "Kodi", "Samuel", "Hately"]]
"Abdul-Aziz"	[7, ["Robin", "Yousif", "Dyllan", "Momin", "Teighen", "Ardal", "Pearce"]]
"Abdul-Majeed"	[4, ["Toluwalase", "Ashley", "Maksim", "Darn"]]
"Abdul-Rehman"	[3, ["Walid", "Maddox", "Olivier"]]
"Abdulbasir"	[7, ["Kinneil", "Markus", "Nicol", "Ayden", "Alekzander", "Cailean", "Tymom"]]
"Abdulkadir"	[4, ["Kaydin", "Dorian", "Aaryan", "Rayden"]]
"Abdulkarem"	[5, ["Al", "Pablo", "Fred", "Yadgor", "David"]]
"Abdulkhader"	[2, ["Hamza", "Lochlan"]]
"Abdullah"	[1, ["Dilraj"]]
"Abdulmalik"	[4, ["Raees", "Conlan", "Kern", "Rudy"]]
"Abdur"	[2, ["Pravin", "Munro"]]
"Abdur-Rahman"	[4, ["Satveer", "Jeswin", "Konrad", "Remigiusz"]]
"Abdur-Rehmaan"	[4, ["Keigan", "Brajan", "Easton", "Jack"]]
"Abdurraheem"	[5, ["Obieluem", "Kaidinn", "Fawkes", "Rossi", "Allen"]]
"Abel"	[3, ["Marvellous", "Klein", "Exodi"]]
"Abhinav"	[2, ["Bogdan", "Tayye"]]
"Abhisumant"	[7, ["Christopher", "Robbie", "Shiloh", "Alec", "Joss", "Yasir", "Lasse"]]
"Abid"	[4, ["Harjeevan", "Nick", "Raul", "Aaran"]]
"Abir"	[4, ["Kyren", "Blaike", "Kashif", "Franco"]]
"Abraham"	[5, ["Joojo", "Rihab", "Khevien", "Ikemsinachukwu", "Malo"]]
"Abu"	[7, ["Connar", "Ryan-Lee", "Burhan", "Zhi", "Anay", "Diesel", "Raith"]]
"Abubakar"	[6, ["Oluwatobiloba", "Benn", "Darcy", "Fionn", "Kyaan", "Rhyon"]]
"Ace"	[5, ["Kenzeigh", "Elisau", "Brooklin", "Griffyn", "Sethu"]]
"Adain"	[4, ["Vinnie", "Bartlomiej", "Jake", "Devin"]]
"Adam"	[4, ["Edwin", "Seaan", "Krish", "Joaquin"]]
"Adam-James"	[1, ["Zack"]]
"Addison"	[4, ["Noor", "Reice", "Calley", "Bader"]]
"Addisson"	[1, ["Jensyn"]]
"Adegbola"	[4, ["Nidhish", "Ivan", "Silas", "Alex"]]
"Adegbolahan"	[3, ["Loukas", "Jayson", "Anubhav"]]
"Aden"	[4, ["Kaydyn", "Fruin", "Bo", "Padraig"]]
"Adenn"	[3, ["Josef", "Davie", "Aulay"]]
"Adie"	[6, ["Bhaaldeen", "Michee", "Ziyaan", "Han", "Rylie", "Jaxon"]]
"Adil"	[1, ["Sharoz"]]
"Aditya"	[4, ["Emanuel", "Gurwinder", "Rafal", "Conlin"]]
"Adnan"	[6, ["McKay", "James-Paul", "Dhavid", "Finn", "Ammar", "Sultan"]]
"Adrian"	[3, ["Arthur", "Murrough", "Dante"]]
"Adrien"	[4, ["Steven-lee", "Rowen", "Zakary", "Lepeng"]]
"Aedan"	[3, ["Kailin", "Feden", "Balian"]]
"Aedin"	[2, ["Aristotelis", "Thom"]]
"Aedyn"	[3, ["Nilav", "Rokas", "Kacper"]]
"Aeron"	[6, ["Cuillin", "Jedd", "Mohammad", "Dylan-Jack", "Kobi", "Haseeb"]]
"Afonso"	[4, ["Patryk", "Bowen", "Robby", "Lauchlin"]]
"Ahmad"	[5, ["Harlee", "Tyler", "Awwal", "Caiden", "Aarman"]]
"Ahmed"	[3, ["Jaydon", "Dominik", "Anthony-John"]]
"Ahmed-Aziz"	[3, ["Ajay", "Franklin", "Chevy"]]
"Ahoua"	[3, ["Khizer", "Enis", "Nathan-Rae"]]
"Ahtasham"	[6, ["Flint", "Tadd", "Benny", "Andrei", "Dilan", "Kane"]]
"Aiadan"	[4, ["Johnpaul", "Aryn", "Tobie", "Ahoua"]]
"Aidan"	[4, ["Kalani", "Amani", "Devon", "Guerin"]]
"Aiden"	[4, ["Sean", "Daniel-James", "Carrich", "Ola-Oluwa"]]
"Aiden-Jack"	[4, ["Aronas", "Brendan", "Codie", "Jock"]]
"Aiden-Vee"	[4, ["Alistar", "Nuada", "Kohen", "Badsha"]]
"Aidian"	[3, ["Dailey", "Reilly", "Jeronimo"]]
"Aidy"	[4, ["Layton", "Cillin", "Keeman", "Peirce"]]
"Ailin"	[7, ["Abdallah", "Ayren", "Luc", "Nikash", "Harris", "Cairn", "Tyrnan"]]
"Aiman"	[5, ["Moad", "Fynlay", "Bob", "Jazib", "Crawford"]]
"Ainsley"	[1, ["Marcello"]]
"Ainslie"	[7, ["Ryszard", "Caelan", "Jaydan", "Kier", "Logan", "Corbin", "Turki"]]
"Airen"	[3, ["Doire", "Fox", "Ricky"]]
"Airidas"	[3, ["Shaunpaul", "Guthrie", "Darren"]]
"Airlie"	[3, ["Conlyn", "Zenith", "Lincon"]]
"Ajay"	[7, ["Kenlin", "Musa", "Gregor", "Ruaidhri", "Titus", "Brody", "Coll"]]
"Ajayraj"	[3, ["Edison", "Sayeed", "Brandon-Lee"]]
"Akan"	[6, ["Kaden", "Zacharius", "Cobain", "Jacky", "Gideon", "Lennan"]]
"Akram"	[5, ["Abdulkarem", "Luis", "Koddi", "Niro", "Regan"]]
"Al"	[4, ["Gavin", "Keaton", "Tee-jay", "Archie"]]
"Al-Hassan"	[7, ["Michat", "Hamza", "Tai", "Ryleigh", "Zishan", "Anesu", "Jason"]]
"Ala"	[5, ["Nico", "Kimi", "Aleksandr", "Robertjohn", "Ayan"]]
"Alan"	[4, ["Jay-Jay", "Aaron-James", "Milos", "Harman"]]
"Alanas"	[2, ["Kaydan", "Chidera"]]
"Alasdair"	[2, ["Lloyde", "Kian-James"]]
"Alastair"	[9, ["Orlando", "Connor", "Michael-James", "Jasim", "Flyn", "Andrew", "Dillan", "Karamvir", "Wilkie"]]
"Alber"	[2, ["Kyel", "Ian"]]
"Albert"	[5, ["Brunon", "Quinn", "Rubyn", "Gurdeep", "Zechariah"]]
"Albie"	[3, ["Kristofer", "Rheyden", "Findlay"]]
"Aldred"	[3, ["Arrham", "Joeddy", "Munir"]]
"Alec"	[4, ["Zaineddine", "Dermot", "Kaidan", "Mathu"]]
"Aled"	[4, ["Konar", "Reis", "Santiago", "Oakley"]]
"Aleem"	[4, ["Morgan", "Peni", "Ari", "Zaaine"]]
"Aleksandar"	[6, ["Ayub", "Alf", "Ewen", "Sohaib", "Kiyonari", "Calan"]]
"Aleksandr"	[5, ["Isaa", "Bodhan", "Roary", "Gabriel", "Sheriff"]]
"Aleksandrs"	[3, ["Averon", "Zubayr", "Loghan"]]
"Alekzander"	[4, ["Jayden-James", "Oskar", "Kyral", "Francisco"]]
"Alessandro"	[5, ["Charly", "Ijay", "Nate", "Ainslie", "Ridley"]]
"Alessio"	[5, ["Amrit", "Khaleel", "Bully", "Mehraz", "Jardine"]]
"Alex"	[3, ["Finnley", "Hussan", "Cayden-Tiamo"]]
"Alexander"	[5, ["Prithvi", "Zander", "Kenton", "Sergio", "Arved"]]
"Alexei"	[3, ["Dev", "Barrie", "Jaise"]]
"Alexx"	[1, ["Hishaam"]]
"Alexzander"	[2, ["Eduards", "Thorfinn"]]
"Alf"	[3, ["Azzedine", "Noel", "Callan"]]
"Alfee"	[3, ["Keayn", "Dyllan", "Momooreoluwa"]]
"Alfie"	[2, ["Declyan", "Geoff"]]
"Alfred"	[5, ["Kinnon", "Cory", "Louie", "Harold", "Sajjad"]]
"Alfy"	[4, ["Antony", "Mir", "Freddie", "Tate"]]
"Alhaji"	[2, ["Trey", "David"]]
"Ali"	[4, ["Idahosa", "William", "Ricco", "Bevin"]]
"Aliekber"	[7, ["Jomuel", "Gurthar", "Tom", "Ashley", "Raegan", "Conley", "Kern"]]
"Alieu"	[3, ["Beau", "McKade", "Rudy"]]
"Alihaider"	[4, ["Timucin", "Murdo", "Casey", "Seb"]]
"Alisdair"	[2, ["Rossi", "Kelvin"]]
"Alishan"	[6, ["Heini", "Vedantsinh", "Kaidyn", "Maaz", "Abid", "Baillie"]]
"Alistair"	[4, ["Keigan", "Ebow", "Morris", "Arihant"]]
"Alistar"	[6, ["Zac", "Nikolai", "Marvin", "Alfie", "Leilan", "Clayton"]]
"Alister"	[5, ["Cruiz", "Reegan", "Lucian", "Exodi", "Klein"]]
"Aliyaan"	[3, ["Dustin", "Christopher", "Bohbi"]]
"Allan"	[2, ["Kiern", "Nickhill"]]
"Allan-Laiton"	[3, ["Loki", "Mikolaj", "Aaren"]]
"Allen"	[7, ["Darryn", "Joojo", "Che", "Kyrillos", "Otto", "Ikemsinachukwu", "Xabier"]]
"Allesandro"	[6, ["Ryan-Lee", "Connel", "Eng", "Khevien", "Torrin", "Raith"]]
"Allister"	[7, ["Symon", "Oluwatoni", "Fionn", "Kyan", "Jarl", "Wei", "Kamran"]]
"Ally"	[5, ["Rhys", "Darcy", "Maison", "Muzzammil", "Eljay"]]
"Alphonse"	[3, ["Grzegorz", "Comghan", "Ruari"]]
"Altyiab"	[5, ["Fiachra", "Kajally", "Vithujan", "Daniel", "Krish"]]
"Alum"	[7, ["Gjan", "Edwyn", "Pietro", "Seamas", "Joaquin", "Kelam", "Breandan"]]
"Alvern"	[3, ["Norman", "Uzayr", "Roray"]]
"Alvin"	[3, ["Aref", "Dafydd", "Abdur"]]
"Alyas"	[1, ["Yuanyu"]]
"Amaan"	[3, ["Nidhish", "Ayman", "Harri"]]
"Aman"	[3, ["Craig", "Paolo", "Bo"]]
"Amani"	[2, ["Alanas", "Sheigh"]]
"Ambanimoh"	[6, ["Ramsay", "Caedyn", "Eonan", "Rylie", "Coray", "Kiegan"]]
"Ameer"	[5, ["Dion", "Idris", "Orson", "Richey", "Mickey"]]
"Amgad"	[2, ["Bryn", "Aidy"]]
"Ami"	[1, ["Jamey"]]
"Amin"	[3, ["Sebastien", "Adrien", "Rhuairidh"]]
"Amir"	[4, ["Kendall", "Tisloh", "Presley", "Roy"]]
"Ammaar"	[4, ["Derry", "Feden", "Kailin", "Jaiden"]]
"Ammar"	[6, ["Jez", "Eden", "Aristotelis", "Motade", "Keiran", "Ren"]]
"Ammer"	[1, ["Sonneey"]]
"Amolpreet"	[2, ["Fabian", "Lucus"]]
"Amos"	[4, ["Arayan", "Tee", "Sami", "Dylan-Jack"]]
"Amrinder"	[5, ["Tyler", "Aleksandar", "Ishwar", "Nickson", "Robert"]]
"Amrit"	[2, ["Sahil", "Jaydyn"]]
"Amro"	[3, ["Owen", "Dominik", "Iman"]]
"Anay"	[1, ["Daryn"]]
"Andrea"	[6, ["Conner", "Michael", "Jarred", "Taddy", "Dilan", "Kane"]]
"Andreas"	[4, ["Rhyse", "John-Paul", "Daren", "Aryn"]]
"Andrei"	[3, ["Elliott", "Tobie", "Guerin"]]
"Andrejs"	[2, ["Rheo", "Ola-Oluwa"]]
"Andrew"	[3, ["Aronas", "Hopkin", "Daniels"]]
"Andy"	[3, ["Glen", "Derick", "Codie"]]
"Anees"	[3, ["Hcen", "Bailee", "Farzad"]]
"Anesu"	[7, ["Eamon", "Yusuf", "Brady", "Cinar", "Jerrick", "Layton", "Teos"]]
"Angel"	[4, ["Alexx", "Marshall", "Justan", "Deelan"]]
"Angelo"	[5, ["Taylor-Jay", "Luca", "Reace", "Harrison", "Cairn"]]
"Angus"	[3, ["Chrismedi", "Yann", "Kaylem"]]
"Anir"	[3, ["Ranolph", "Sher", "Turki"]]
"Anis"	[5, ["Jaydan", "Saad", "Mika", "Francesco", "Corbin"]]
"Anish"	[3, ["Kym", "Igor", "Ricky"]]
"Anmolpreet"	[5, ["Russel", "Bryson", "Jan", "Zennon", "Lincon"]]
"Annan"	[4, ["Aedin", "Rhudi", "Finnen", "Benedict"]]
"Anndra"	[5, ["Tiylar", "Prinay", "Danys", "Johnathan", "Eli"]]
"Anselm"	[6, ["Zakk", "Levi", "Deshawn", "Barkley", "Kainin", "Stewarty"]]
"Anthony"	[4, ["Damon", "Korrin", "Vince", "Jian"]]
"Anthony-John"	[4, ["Keiron", "Gideon", "Phoenix", "Lennan"]]
"Antoine"	[4, ["Mason", "Faisal", "Dennys", "Niven"]]
"Anton"	[3, ["Arda", "Keaton", "Curtis"]]
"Antoni"	[6, ["Yorgos", "Siddharth", "Declain", "Aleksandr", "Ismaeel", "Gavin-Lee"]]
"Antonio"	[4, ["Kingston", "Lorne", "Ayan", "Rayane"]]
"Antony"	[3, ["Frazer", "Lachlan", "Jay-Jay"]]
"Antonyo"	[5, ["Shaye", "Indy", "Manson", "Athos-Carlos", "Neco"]]
"Anubhav"	[3, ["Cade", "Dillon", "Taegan"]]
"Aodhan"	[4, ["Ibraheem", "Makin", "Celik", "Kyhran"]]
"Aon"	[2, ["Zeek", "Nader"]]
"Aonghus"	[6, ["Kaleem", "Dex", "Amgad", "Jamal", "Sukhpal", "Mcbride"]]
"Apisai"	[2, ["Kristoffer", "Sean-Paul"]]
"Arafat"	[5, ["Ross", "Jahid", "Zaineddine", "Tiernan", "Kelum"]]
"Aran"	[3, ["Calum", "Favour", "Dermot"]]
"Arandeep"	[4, ["Morgan", "Eassan", "Peni", "Dakota"]]
"Arann"	[6, ["Alf", "Martyn", "Leigham", "Kaan", "Jace", "C-Jay"]]
"Aray"	[3, ["Calder", "Abdirahman", "Ubaid"]]
"Arayan"	[5, ["Pasquale", "Tayo", "Gallagher", "Bodhan", "Yaseen"]]
"Archibald"	[3, ["Dawud", "Ericlee", "Joshua"]]
"Archie"	[5, ["Haris", "Domenico", "Sachkirat", "Loghan", "Zuriel"]]
"Arda"	[4, ["Binod", "Charly", "Shaurya", "Wylie"]]
"Ardal"	[3, ["Rahim", "Habeeb", "Nate"]]
"Ardeshir"	[5, ["Amrit", "Finnley", "Syed", "Wayde", "Oluwalayomi"]]
"Areeb"	[2, ["Rhyley", "Mustapha"]]
"Areez"	[3, ["Zander", "Maximillian", "Prithvi"]]
"Aref"	[2, ["Reuben", "Adam-James"]]
"Arfin"	[3, ["Zachary-Marc", "Thorfinn", "Muhammad"]]
"Argyle"	[6, ["Lennon", "Masson", "Ronnie", "Famara", "Jad", "Kaeden"]]
"Argyll"	[5, ["Kodie", "Jenson", "Callan-Adam", "Ardeshir", "Lukas"]]
"Ari"	[4, ["Alessandro", "Bradan", "Pearse", "Geoff"]]
"Aria"	[5, ["Tymon", "Kinnon", "Siergiej", "Rayhan", "Aydin"]]
"Arian"	[7, ["Kaydn", "Antony", "Mirza", "Blue", "Pacey", "Aaryn", "Tate"]]
"Aristomenis"	[2, ["Zishan", "Ramit"]]
"Aristotelis"	[2, ["Rice", "Orrick"]]
"Arjuna"	[1, ["Maksymilian"]]
"Arlo"	[6, ["Zeid", "Rufus", "Kalen", "Liam-Stephen", "Conley", "Jameil"]]
"Armaan"	[4, ["Madison", "Casper", "Wallace", "Kruz"]]
"Arman"	[2, ["Zakaria", "Precious"]]
"Armen"	[6, ["Veeran", "Jai", "Allesandro", "Obosa", "Rowan", "Matteo"]]
"Arnab"	[3, ["Cambell", "Maaz", "Remo"]]
"Arnav"	[4, ["Phani", "Zach", "Clayton", "Rohit"]]
"Arnold"	[4, ["Nikolai", "Kabir", "Hasan", "Azedine"]]
"Aron"	[6, ["Cruiz", "Garren", "Luciano", "Kealon", "Bohbi", "Sambrid"]]
"Aronas"	[5, ["Latif", "Shiraz", "Nickhill", "Aled", "Awais"]]
"Arran"	[4, ["Jayden-Thomas", "Cai", "Ernie-Jacks", "Aaren"]]
"Arrham"	[4, ["Ilyaas", "Tane", "Owain", "Frank"]]
"Arron"	[1, ["Torrin"]]
"Arryn"	[2, ["Liyonela-Elam", "Bennett"]]
"Arsalan"	[4, ["Wen", "Johnny", "Oluwatoni", "Kyan"]]
"Artem"	[5, ["Grzegorz", "Comghan", "Zayd", "Aryankhan", "Ruaridh"]]
"Arthur"	[3, ["Krishan", "Carlos", "Maxwell"]]
"Artur"	[6, ["Joash", "Arnold", "Addisson", "Reynold", "Seamas", "Tiago"]]
"Arturo"	[2, ["Stanislaw", "Jadyn"]]
"Arun"	[4, ["Norman", "Farhan", "Callie", "Reid"]]
"Arunas"	[3, ["Aref", "Lawson", "Sandro"]]
"Arved"	[3, ["Alexander", "Tyra", "Nihaal"]]
"Arya"	[4, ["Craig", "Kirk", "Rayyan", "Jaz"]]
"Aryan"	[5, ["Riyadh", "Laison", "Paolo", "Ireoluwa", "Alanas"]]
"Aryankhan"	[2, ["Davis", "Hansen"]]
"Aryian"	[3, ["Lock", "Jaxson", "Forrest"]]
"Aryn"	[5, ["Aidy", "Malachy", "Kyle-Derek", "Nash", "Darrel"]]
"Asa"	[7, ["Gus", "Lincoln", "Conlly", "Rupert", "Bryn", "Rafferty", "Tommi-Lee"]]
"Asfhan"	[2, ["Rhuan", "Ksawery"]]
"Ash"	[3, ["Johannes", "Selasi", "Brodi"]]
"Ashlee-jay"	[2, ["Jaidyn", "Banan"]]
"Ashley"	[1, ["Victory"]]
"Ashton"	[4, ["Arjuna", "Brandonlee", "Motade", "Leland"]]
"Ashton-Lloyd"	[3, ["Koby", "Niraj", "Azim"]]
"Ashtyn"	[6, ["Dylan-James", "Reeve", "Teejay", "Abdulkadir", "Lucus", "Hashem"]]
"Ashwin"	[2, ["Laughlan", "Chukwuemeka"]]
"Asif"	[2, ["Harleigh", "Nicky"]]
"Asim"	[3, ["Donald", "Franko", "Xiao"]]
"Aslam"	[4, ["Kyrran", "Manmohan", "Nawfal", "Athol"]]
"Asrar"	[3, ["Haider", "Lliam", "Zidane"]]
"Ata"	[3, ["Kye", "Ahtasham", "Benoit"]]
"Atal"	[2, ["Mylo", "Daren"]]
"Atapattu"	[4, ["Ambanimoh", "Conan", "Rubhan", "Ze"]]
"Ateeq"	[1, ["Kristin"]]
"Athol"	[4, ["Zain", "Brendon", "Muneeb", "Tiarnan"]]
"Athon"	[5, ["Derick", "Valentino", "Mathias", "Reily", "Bailee"]]
"Athos-Carlos"	[2, ["Hcen", "Keenan"]]
"Atli"	[5, ["Lee", "Peiyan", "Jaay", "Alexx", "Sofian"]]
"Atom"	[4, ["Sam", "Tyrone", "Reace", "Harrison"]]
"Attila"	[2, ["Parker", "Moayd"]]
"Aulay"	[1, ["Turner"]]
"Aun"	[5, ["Jayden", "Talorcan", "Saad", "Dolan", "Mikael"]]
"Austen"	[4, ["Darrie", "Francesco", "Osesenagha", "Karthikeya"]]
"Austin"	[6, ["Jonny", "Guy", "Tomson", "Raheem", "Zennon", "Emir"]]
"Avani"	[5, ["Oluwafemi", "Jaosha", "Mehmet", "Diarmid", "Connal"]]
"Averon"	[5, ["Kuba", "Daood", "Aedyn", "Mahan", "Husnain"]]
"Avi"	[5, ["Tiylar", "Prinay", "Colm", "Brogan", "Jai-Rajaram"]]
"Avinash"	[6, ["Ohran", "Barney", "Vincent", "Deshawn", "Fergie", "Adain"]]
"Avraham"	[4, ["Keiryn", "Phoevos", "Armaan", "Macaully"]]
"Awais"	[2, ["Coban", "Ronan-Benedict"]]
"Awwal"	[3, ["Hassanali", "Arda", "Samual"]]
"Axel"	[2, ["Ciann", "Pawlo"]]
"Ayaan"	[5, ["Tyllor", "Mark", "Nicodemus", "Aydan", "Jude"]]
"Ayan"	[3, ["Tarik", "Blazey", "Jayke"]]
"Aydan"	[4, ["Rioden", "Lachlan", "Akram", "Ozzy"]]
"Ayden"	[4, ["Ralph", "Loche", "Atli", "Hamish"]]
"Aydin"	[3, ["Bernard", "Andy", "Will"]]
"Aydon"	[4, ["Jole", "Makin", "Nader", "Shai"]]
"Ayman"	[2, ["Bryan", "Jamal"]]
"Ayomide"	[2, ["Olie", "Kristoffer"]]
"Ayren"	[5, ["Kelvan", "Joel", "Grady", "Arron", "Pranav"]]
"Ayrton"	[7, ["Allan-Laiton", "Ross-Andrew", "Stephenjunior", "Oban", "Bailley", "Coel", "Mathuyan"]]
"Aytug"	[6, ["Heidar", "Lysander", "Valo", "Morgyn", "Jesuseun", "Abhinav"]]
"Ayub"	[3, ["Clark", "Braiden", "Zaak"]]
"Ayyub"	[5, ["Kjae", "Harvie", "Demetrius", "Ubaid", "Reece"]]
"Azaan"	[6, ["Modu", "Kaywan", "Jean-Pierre", "Cristian", "Tayyab", "Boedyn"]]
"Azedine"	[3, ["Avi", "Gallagher", "Yasin"]]
"Azeem"	[4, ["Zuriel", "Erik", "Kierin", "Saffi"]]
"Azim"	[3, ["Kash", "Tammam", "Mikhail"]]
"Aziz"	[2, ["Asrar", "Darryl"]]
"Azlan"	[6, ["Diego", "Ryan", "Jared", "Connan", "Rahman", "Sylvain"]]
"Azzam"	[6, ["Afonso", "Ceejay", "Benji", "Kurtis-Jae", "Seth", "Hussnain"]]
"Azzedine"	[5, ["Griffin", "Brooke", "John-Michael", "Muzammil", "Kenyon"]]
"Babatunmise"	[3, ["Vinh", "Alyas", "Kris"]]
"Babur"	[5, ["Dane", "Muhammed", "Arnab", "Edward", "Thrinei"]]
"Bader"	[3, ["Masson", "Zachery", "Pieter"]]
"Badr"	[8, ["Kody", "Callan-Adam", "Kael", "Rehan", "Spencer", "Havila", "Lukasz", "Fares"]]
"Badsha"	[7, ["Samy", "Dyllan-James", "Pearse", "Yu", "Braden", "Te-Jay", "Daegan"]]
"Bailee"	[4, ["Alessandro", "Declyn", "Nicolas", "Marley"]]
"Bailey"	[3, ["Mirza", "Salahudin", "Louis"]]
"Bailie"	[4, ["Kaydn", "Ritchie", "Yago", "Blyth"]]
"Baillie"	[6, ["Dinaras", "Bezalel", "Ryley", "Ziya", "Tait", "Cooper"]]
"Baley"	[6, ["Jon", "Rice", "William-John", "Kylar", "Idrees", "Forbes"]]
"Balian"	[4, ["Kerr", "Zein", "Nairn", "James"]]
"Banan"	[4, ["Rhoridh", "Krzysiek", "Dharam", "Kalin"]]
"Barath"	[5, ["Hubert", "Sebastian", "Artem", "Adnan", "Briaddon"]]
"Barkley"	[2, ["Colby", "Zakariya"]]
"Barney"	[2, ["Korben", "Dalong"]]
"Baron"	[2, ["Aristomenis", "Leiten"]]
"Barrie"	[6, ["Jackie", "Marwan", "Sol", "Kacey", "Azedine", "Ezekiel"]]
"Barry"	[4, ["Caleb", "Rees", "Jed", "Cruz"]]
"Bartlomiej"	[4, ["Yassin", "Patrikas", "Isher", "Lauchlan"]]
"Bartosz"	[3, ["Shreeram", "Tylar", "Nicki"]]
"Basher"	[6, ["Anthony", "Sahaib", "Dominick", "Owain", "Tane", "Miles"]]
"Basile"	[4, ["Jordan", "Nathaniel", "Kyro", "Chester"]]
"Baxter"	[6, ["Zhuo", "Butchi", "Raithin", "Andrea", "Torsten", "Hagun"]]
"Baye"	[2, ["Szymon", "Kamron"]]
"Bayley"	[4, ["Johnny", "Kenzi", "Pushkar", "Ahmed-Aziz"]]
"Beau"	[1, ["Ruaridh"]]
"Beinn"	[6, ["Joash", "Carlos", "Daniele", "Krishan", "Rhein", "Adegbola"]]
"Bekim"	[6, ["Kelan", "Piotr", "Rori", "Codey", "Leno", "Tiago"]]
"Believe"	[4, ["Deon", "Valen", "Kaelin", "Kogan"]]
"Ben"	[6, ["Reigan", "Abdurraheem", "Teo", "Haydon", "Arfin", "Lukmaan"]]
"Bendeguz"	[5, ["Layne", "Yuri", "Geordie", "Bradlie", "Ivar"]]
"Benedict"	[5, ["Kirk", "Nihaal", "Rayyan", "Lovell", "Abbas"]]
"Benjamin"	[5, ["Jazeb", "Lakshya", "Boab", "Kayleb", "Salter"]]
"Benjamyn"	[2, ["Marc-Anthony", "Ireoluwa"]]
"Benji"	[1, ["Miguel"]]
"Benn"	[3, ["Karson", "Richie", "Malachy"]]
"Bennett"	[6, ["Zendel", "Rafferty", "Brynmor", "Nash", "Gustav", "Emil"]]
"Benny"	[5, ["Kallin", "Finnan", "McLay", "Jamie", "Ben"]]
"Benoit"	[3, ["Humza", "Ksawery", "Warkhas"]]
"Bentley"	[3, ["Jaidyn", "Leven", "Eisa"]]
"Berkay"	[2, ["Felix", "Korey"]]
"Bernard"	[1, ["Brandonlee"]]
"Bertie"	[3, ["Gianluca", "Sonni", "Al-Hassan"]]
"Bevin"	[4, ["Umer", "Koby", "Hashim", "Luic"]]
"Bezalel"	[4, ["Dylan-James", "Keatin", "Robert-Gordon", "Bowie"]]
"Bhaaldeen"	[4, ["Eshan", "Isimeli", "Shyam", "Nicky"]]
"Bharath"	[5, ["Aaron", "Harley", "Milo", "Tanzeel", "Jayhan"]]
"Bilal"	[6, ["Kavin", "Kyrran", "Ajayraj", "Chibudom", "Franko", "Rikki"]]
"Bill"	[6, ["Hamad", "Athon", "Zidane", "Enrico", "Rajan", "Nawfal"]]
"Billy"	[5, ["Michael-Alexander", "Tadhg", "Wiktor", "Karam", "Connolly"]]
"Binod"	[3, ["John-Scott", "Makensie", "Aiadan"]]
"Bjorn"	[5, ["Ze", "Bruno", "Jakub", "Kenzy", "Rubin"]]
"Blaike"	[4, ["Rhett", "Aden", "Vrishin", "Olaoluwapolorimi"]]
"Blaine"	[7, ["Prabodhan", "Mungo", "Daniil", "Glenn", "Efe", "Tibet", "Arran"]]
"Blair"	[5, ["Nyah", "Jago", "Mathias", "Zaine", "Kaid"]]
"Blaire"	[4, ["Abdur-Rehmaan", "Jerry", "Lyle", "Fauzaan"]]
"Blake"	[2, ["Yves", "Jaay"]]
"Blazej"	[4, ["Ewan", "Nikhil", "Justin", "Reagan"]]
"Blazey"	[7, ["Abdalroof", "Drew", "Lucais", "Saman", "Bobby-Lee", "Apisai", "Kaylum"]]
"Blessing"	[6, ["Fynn", "Isa", "Alber", "Marcin", "Roark", "Christian"]]
"Blue"	[5, ["Raphael", "Caelen", "Sabeen", "Eric", "Kieran-Scott"]]
"Blyth"	[2, ["Tamar", "Francis"]]
"Bo"	[4, ["Ihtisham", "Tony", "Jonothan", "Ainsley"]]
"Boab"	[3, ["Russell", "Connal", "Rahil"]]
"Bob"	[4, ["Hussain", "Kurt", "Aedyn", "Warrick"]]
"Bobby"	[3, ["TJ", "Kenneth", "Levon"]]
"Bobby-Lee"	[5, ["Ohran", "Jai-Rajaram", "Vincent", "Strachan", "Kainui"]]
"Bodhan"	[4, ["Arman", "Adain", "Muhamadjavad", "Reno"]]
"Boedyn"	[6, ["Keiryn", "Brannan", "Gil", "Jacques", "Lennen", "Coben"]]
"Bogdan"	[5, ["Sorley", "Azzam", "Faizaan", "Hassanali", "Abdullah"]]
"Bohbi"	[3, ["Pawlo", "Teighen", "Cyrus"]]
"Bony"	[2, ["Sidharth", "Jules"]]
"Bowen"	[7, ["Kinneil", "Antonio", "Esteban", "Corrie", "Sajid", "Loudon", "Cailaen"]]
"Bowie"	[4, ["Dorian", "Ines", "Ozzy", "Tarik"]]
"Boyd"	[3, ["Kiaran", "Trent", "Mantej"]]
"Bracken"	[5, ["Dilraj", "Jaskaran", "Michal", "Anees", "Bernard"]]
"Brad"	[4, ["Fodeba", "Orley", "Shane", "Aiden"]]
"Bradan"	[5, ["Radmiras", "Zeeshan", "Toluwalase", "Gursees", "Bryce"]]
"Braden"	[5, ["Sukhvir", "Ami", "Jameel", "Findlie", "Kristopher"]]
"Bradley"	[3, ["Sean-Ray", "Munmair", "Arryn"]]
"Bradlie"	[3, ["Kelvan", "Leonard", "Mati"]]
"Bradly"	[5, ["Obieluem", "Kaidinn", "Calum-James", "Bailley", "Remigiusz"]]
"Brady"	[4, ["Satveer", "Daksh", "Kehinde", "Arian"]]
"Bradyn"	[3, ["Demetrius", "Marvellous", "Jack"]]
"Braeden"	[7, ["Arandeep", "Kjae", "Modu", "Abdisalam", "Harvie", "Lucca", "Crombie"]]
"Braiden"	[5, ["Aldred", "Kealan", "Gareth", "Tayyab", "Boedyn"]]
"Brajan"	[7, ["Nick", "Erik", "Shiloh", "Rasul", "Marcous", "Tye", "Cahlum"]]
"Brandan"	[5, ["Bjorn", "Oswald", "Aaran", "Tammam", "Cori"]]
"Branden"	[6, ["Shaw", "Franco", "Jonson", "Airidas", "Kyren", "Wynn"]]
"Brandon"	[5, ["Connar", "Burhan", "Ryan", "Nathan", "Jarell"]]
"Brandon-Lee"	[4, ["Hussnain", "Aryan", "Elisau", "Brooklin"]]
"Brandonlee"	[7, ["Oluwatobiloba", "Ceejay", "Diego", "Benji", "Wayne", "Melville", "Fintan"]]
"Brandyn"	[5, ["Maximus", "Ruaraidh", "Alyas", "Colum", "Devan"]]
"Brannan"	[4, ["Danial", "Mack", "Ojima-Ojo", "Vinnie"]]
"Brayden"	[4, ["Arnav", "Girius", "Lennox", "Muhammed"]]
"Braydon"	[4, ["Kael", "Noor", "Rooke", "Kody"]]
"Braydyn"	[4, ["Dyllon", "Te-Jay", "Daegyu", "Rehan"]]
"Breandan"	[4, ["Ciarian", "Lawrie", "Declyn", "Alessio"]]
"Brehme"	[1, ["Tymoteusz"]]
"Brendan"	[6, ["Yahya", "Antonyo", "Taylan", "Kaydyn", "Douglas", "Jayson"]]
"Brendon"	[5, ["Sheafan", "Josan", "Aulay", "Neo", "Laird"]]
"Brendyn"	[2, ["Michee", "Angel"]]
"Breogan"	[3, ["Willum", "Karl", "Forbes"]]
"Bret"	[6, ["Ashton-Lloyd", "Nairn", "Kevan", "Tomas", "Sharland", "Brydon"]]
"Brett"	[2, ["Kalin", "Bekim"]]
"Briaddon"	[6, ["Rhoridh", "Walter", "Sebastian", "Johann", "Hugh", "Finley"]]
"Brian"	[3, ["Tiree", "Eihli", "Jaida"]]
"Brodi"	[3, ["Korben", "Victor", "Derron"]]
"Brodie"	[4, ["Aristomenis", "Ed", "Thierry", "Henri"]]
"Brody"	[4, ["Jackie", "Marwan", "Zachariah", "Rokas"]]
"Brogan"	[3, ["Azeem", "Rees", "Nikos"]]
"Broghan"	[6, ["Garrett", "Yoji", "Kean", "Patryk", "Lauchlan", "Bony"]]
"Brooke"	[4, ["Marcus", "Aleem", "Shreeram", "Tylar"]]
"Brooklin"	[5, ["Kieryn", "Dominick", "Lorcan", "Ravin", "Millar"]]
"Brooklyn"	[4, ["Xavier", "Chevy", "Ilyas", "Blair"]]
"Bruce"	[7, ["Zhuo", "Butchi", "Khizer", "Torsten", "Jordi", "Atapattu", "Nathaniel"]]
"Bruin"	[6, ["Ryder", "Kamron", "Jarno", "Omar", "Andreas", "Fletcher"]]
"Bruno"	[1, ["Ahmed-Aziz"]]
"Brunon"	[5, ["Ruben", "Lex", "Conal", "Eljon", "Amani"]]
"Bryan"	[4, ["Devlyn", "Carrich", "Maxx", "Filip"]]
"Bryce"	[5, ["Daniele", "Munachi", "Tian", "Brehme", "Adegbola"]]
"Bryden"	[3, ["Zaid", "Stanley", "Kaelum"]]
"Brydon"	[4, ["Valen", "Kohen", "Luqman", "Norrie"]]
"Brydon-Craig"	[5, ["Moore", "Layne", "Bradly", "Geordie", "Rodrigo"]]
"Bryn"	[5, ["Jura", "Evan", "Kirwin", "Alexei", "Maros"]]
"Brynmor"	[3, ["Mitchell", "Abbas", "Salvador"]]
"Bryson"	[5, ["Fyn", "Alasdair", "Yanick", "Davy", "Pardeepraj"]]
"Buddy"	[6, ["Corben", "Rana", "Kier", "Josese", "Austen", "Nevin"]]
"Bully"	[3, ["Jay", "Talon", "Bilal"]]
"Burak"	[6, ["Ieuan", "Nasser", "Tommy", "Ashwin", "Emil", "Darrell"]]
"Burhan"	[6, ["Zenith", "Kevyn", "Diarmaid", "Ruslan", "McLay", "Brynmor"]]
"Butali"	[3, ["Aedan", "Magnus", "Sunny"]]
"Butchi"	[6, ["Kendyn", "Zakir", "Greg", "Danyil", "Musa", "Eisa"]]
"Byron"	[6, ["Stewart", "Deryn", "Leven", "Ogheneochuko", "Ruadhan", "Barath"]]
"C-Jay"	[6, ["Julian", "Markus", "Ethan", "Ayden", "Israel", "Ciaran"]]
"CJ"	[2, ["Ardeshir", "Teiyib"]]
"Cabhan"	[5, ["Abubakar", "Vinay", "Macauley", "Jia", "Reng"]]
"Cadan"	[4, ["Keiren", "Ediomi", "Gianmarco", "Zacharius"]]
"Cade"	[5, ["Umer", "Denny", "Aziz", "Hashim", "Fahad"]]
"Caden"	[5, ["Luic", "Abdulkarem", "Tee-jay", "Dylan-John", "Jeemie"]]
"Cadon"	[5, ["Cian", "Siddhant", "Aleksander", "Isira", "Robert-Gordon"]]
"Cadyn"	[3, ["Eshan", "Rayan", "Saif"]]
"Caedan"	[3, ["Tanzeel", "Anton", "Kayam"]]
"Caedyn"	[2, ["Enrico", "Travis"]]
"Cael"	[2, ["Cadan", "Hamad"]]
"Caelan"	[3, ["Iain", "Makenzie", "Darien"]]
"Caelen"	[2, ["Ellis", "Nabeel"]]
"Caethan"	[3, ["Kaleb", "Conar", "Devyn"]]
"Cahl"	[5, ["Arrham", "Daniil", "Ege", "Sean-James", "Joe"]]
"Cahlum"	[4, ["Brendyn", "Kelso", "Roshan", "Zaine"]]
"Cai"	[6, ["Fauzaan", "Oakley", "Derin", "Reis", "Callyn", "Kaidan"]]
"Caidan"	[4, ["Lyle", "Ari", "Moray", "Daithi"]]
"Caiden"	[5, ["Alexzander", "Justin", "Roger", "Leigh", "Yves"]]
"Caiden-Paul"	[3, ["Tyson", "Jean", "Arafat"]]
"Caidyn"	[7, ["Pascoe", "Yannick", "Roary", "Bobby-Lee", "Christian", "Gabriel", "Dugald"]]
"Caie"	[5, ["Joshiah", "Raphael", "Dawson", "Eric", "Marco"]]
"Cailaen"	[7, ["Domanic", "Zubair", "Sabeen", "Billy", "Harikrishna", "Anish", "Logan-Rhys"]]
"Cailean"	[7, ["Malcolm", "Ihtisham", "Ainslie", "Kyral", "Charlie", "Jonothan", "Oskar"]]
"Caileb-John"	[4, ["Linton", "Rahil", "Zeph", "Natan"]]
"Cailin"	[4, ["Amrinder", "Kurt", "Wasif", "Kameron"]]
"Cain"	[2, ["Arved", "Dara"]]
"Caine"	[6, ["Alvern", "Zamaar", "Greig", "Levy", "Broghan", "Maximilian"]]
"Cairn"	[3, ["Kory", "Danar", "Baron"]]
"Cal"	[4, ["Zachary", "Eduards", "Muhamadjavad", "Arman"]]
"Calan"	[4, ["Jacques", "Soul", "Faizaan", "Ronin"]]
"Calder"	[4, ["Daanyaal", "Abdullah", "Ardal", "Momin"]]
"Cale"	[3, ["Keayn", "Pearce", "Lawlyn"]]
"Calean"	[7, ["Ayden", "Tylor", "Harold", "Cailean", "Sidney", "Rayden", "Declan"]]
"Caleb"	[7, ["Antonio", "Cory", "Mir", "Fred", "Tariq-Jay", "Kaydin", "Sajid"]]
"Calen"	[4, ["Joris", "Chin", "Rishi", "Yadgor"]]
"Caley"	[4, ["Caden", "Ramanas", "Rylee", "Lochlan"]]
"Calib"	[3, ["Kyie", "Michat", "Riccardo"]]
"Calin"	[3, ["Nagib", "Toluwalase", "Jomuel"]]
"Callahan"	[3, ["Raees", "Zeeshan", "Conlan"]]
"Callan"	[4, ["Adil", "Maddox", "Kristopher", "Walid"]]
"Callan-Adam"	[2, ["Pravin", "Kelvin"]]
"Calley"	[1, ["Kaidinn"]]
"Callie"	[3, ["Daksh", "Calvin", "Morris"]]
"Callin"	[5, ["Ghyll", "Peter", "Clarke", "Denis", "Leighton"]]
"Callum"	[2, ["Nikodem", "Klein"]]
"Callun"	[2, ["Kealan", "Tayye"]]
"Callyn"	[4, ["Shiloh", "Marcous", "Lasse", "Eriz"]]
"Calum"	[3, ["Aaran", "Anndra", "Mikolaj"]]
"Calum-James"	[3, ["Xabier", "Tanay", "Ikemsinachukwu"]]
"Calvin"	[3, ["Shaw", "Burhan", "Khevien"]]
"Cambell"	[1, ["Benn"]]
"Camerin"	[5, ["Daragh", "Ceilan", "Johnnie", "Kyaan", "Sethu"]]
"Cameron"	[3, ["Zarran", "Brooklin", "Ruari"]]
"Campbel"	[7, ["Carl", "Vinnie", "Ojima-Ojo", "Rexford", "Devin", "Krish", "Bartlomiej"]]
"Campbell"	[3, ["Seaan", "Keivlin", "Mackenzie"]]
"Camron"	[5, ["Pietro", "Kaelan", "Spondon", "Rooke", "Jadon"]]
"Caolain"	[3, ["Calley", "Abdul-Rehman", "Luke"]]
"Caolan"	[5, ["Areez", "Bradley", "Lawrie", "Yuanyu", "Cieran"]]
"Carl"	[2, ["Etinosa", "Dedeniseoluwa"]]
"Carlo"	[5, ["Loukas", "Salman", "Taylar", "Mitch", "Cailin"]]
"Carlos"	[4, ["Yahya", "Ireayomide", "Fruin", "David-Lee"]]
"Carrich"	[1, ["Aulay"]]
"Carrick"	[1, ["Karl"]]
"Carson"	[7, ["Chad", "Darragh", "Idris", "Aidian", "Richard", "Sharoz", "Jonah"]]
"Carter"	[4, ["Kevan", "McKay", "Rafal", "James-Paul"]]
"Carwyn"	[3, ["Kallan", "Sultan", "Rhuairidh"]]
"Casey"	[4, ["Arthur", "Murrough", "Johann", "Sebastien"]]
"Casper"	[2, ["Zakary", "Balian"]]
"Cassy"	[6, ["Savin", "Korbyn", "Abraham", "Macallum", "Dalton", "Jeyun"]]
"Cathal"	[5, ["Brandon", "Eddie", "Aristotelis", "Zachariah", "Philip"]]
"Cator"	[4, ["Calen", "Alfy", "Solomon", "Kacper"]]
"Cavan"	[6, ["Abdulbasir", "Sami", "Mohammad", "Lucien", "Dylan-Jack", "Arayan"]]
"Cayden"	[7, ["Yoji", "Shreyas", "Robby", "Mario", "Lauchlin", "Patryk", "Christy"]]
"Cayden-Robert"	[4, ["Harlee", "Kieryn", "Awwal", "Tyler"]]
"Cayden-Tiamo"	[5, ["Dominik", "Sahbian", "Xavier", "Owais", "Millar"]]
"Ceejay"	[1, ["Ateeq"]]
"Ceilan"	[7, ["Ryder", "Jarred", "Zi", "Khizer", "LLeyton", "Micah", "Dilan"]]
"Ceiran"	[5, ["Rhyse", "I", "Ahoua", "Maitlind", "Kyden"]]
"Ceirin"	[4, ["Johnpaul", "Zayn", "Aryn", "Qasim"]]
"Ceiron"	[4, ["Ruben", "Basher", "Conall", "Filip"]]
"Cejay"	[7, ["Kriss", "Rheo", "Daniel-James", "Mackie", "Sean", "Carrich", "Jock"]]
"Celik"	[5, ["Brendan", "Rorie", "Alistar", "Lenon", "Efan"]]
"Cephas"	[5, ["Reilly", "Kohen", "Callum", "Mathew", "Derek"]]
"Cesar"	[2, ["Teodor", "Peirce"]]
"Cesare"	[1, ["Ayren"]]
"Chad"	[3, ["Tyrnan", "Kirwin", "Raza"]]
"Chaitanya"	[2, ["Dregan", "Parkash"]]
"Chang-Ha"	[5, ["Caelan", "Sher", "Kier", "Nevin", "Austin"]]
"Charles"	[5, ["Mika", "Anir", "Zohair", "Hareem", "Corbin"]]
"Charley"	[2, ["Aiman", "Bilal"]]
"Charlie"	[4, ["Bryson", "Zenith", "Nasser", "Asif"]]
"Charly"	[2, ["Finnean", "Diarmaid"]]
"Chase"	[3, ["Aedin", "Magnus", "Arun"]]
"Che"	[4, ["Preston-Jay", "Levi", "Gregor", "Coll"]]
"Chester"	[6, ["Fergal", "Kori", "Kaine", "Vince", "Stewarty", "Macauley"]]
"Chevy"	[2, ["Jian", "Phoenix"]]
"Chi"	[4, ["Ali", "Azlan", "Cobain", "Denny"]]
"Chibudom"	[1, ["Regan"]]
"Chidera"	[5, ["Keaton", "Aleksandr", "Dylan-John", "Isira", "Pawel"]]
"Chimsom"	[5, ["Essa", "Siddharth", "Rayan", "Kimi", "Ayan"]]
"Chin"	[4, ["Kayam", "Aaron-James", "Milos", "Harman"]]
"Chintu"	[5, ["Inan", "Fraser", "Xin", "Manolo", "Riley"]]
"Chiqal"	[2, ["Connor", "Nayan"]]
"Chiron"	[3, ["Kyel", "Wilkie", "Michael-James"]]
"Chris"	[4, ["Shahmir", "Aidan", "Makenzie", "Nadeem"]]
"Chris-Daniel"	[3, ["Amgad", "Mazin", "Devyn"]]
"Chrismedi"	[2, ["Kristofer", "Adenn"]]
"Christian"	[5, ["Arrham", "Leo", "Ege", "Sean-James", "Brendyn"]]
"Christie"	[7, ["Favour", "Valery", "Bailie", "Dermot", "Mathu", "Jaheim", "Kaidan"]]
"Christoph"	[5, ["Calum", "Heddle", "Lyndsay", "Santiago", "Reis"]]
"Christopher"	[2, ["Peni", "Leigh"]]
"Christopher-Lee"	[5, ["Ewen", "Reean", "Kiyonari", "Tyson", "Abdihakim"]]
"Christy"	[6, ["Tayo", "Modoulamin", "Kayne", "Lucas", "Samar", "Dugald"]]
"Chu"	[9, ["Christie", "Niall", "Roary", "Averon", "Yaseen", "Isaa", "Albie", "Landon", "Marco"]]
"Chukwuemeka"	[2, ["Jayden-James", "Anmolpreet"]]
"Cian"	[3, ["Binod", "Kasey", "Francisco"]]
"Ciann"	[5, ["Jon-Paul", "Malik", "Ainslie", "Torin", "Rahim"]]
"Ciar"	[4, ["Ryaan", "Didier", "Benjamyn", "Jardine"]]
"Ciaran"	[3, ["Sergio", "Oluwafikunayomi", "Wasif"]]
"Ciarian"	[3, ["Prithvi", "Arved", "Greig"]]
"Cieran"	[4, ["Dev", "Caolain", "Barrie", "Jaise"]]
"Cillian"	[2, ["Eduards", "Maciej"]]
"Cillin"	[2, ["Lennex", "Brayden"]]
"Cinar"	[2, ["Azzedine", "Rehaan"]]
"Clark"	[1, ["Cory"]]
"Clarke"	[1, ["Freddie"]]
"Clayton"	[3, ["Nelson", "Shazil", "Eoghain"]]
"Clement"	[7, ["Anesu", "Michat", "Rylee", "Dimitri", "Orran", "Folarinwa", "Karim"]]
"Clifford"	[3, ["Cesar", "Naif", "Ricco"]]
"Clyde"	[5, ["Zeid", "Rudy", "Liam", "Tom", "Conley"]]
"Cobain"	[4, ["Finlay", "Beau", "Dhani", "McKade"]]
"Coban"	[3, ["Danniel", "Arsalan", "Aditya"]]
"Coben"	[1, ["Kaidyn"]]
"Cobi"	[5, ["Maanav", "Dale", "Fawkes", "Calvin", "Remo"]]
"Cobie"	[6, ["Keigan", "Leilan", "Jeswin", "Brandan", "Theodore", "Morris"]]
"Coby"	[3, ["Jacki", "Denis", "Uchenna"]]
"Codey"	[7, ["Cruiz", "Arann", "Jebadiah", "Samatar", "Abdul", "Calean", "Lucian"]]
"Codi"	[4, ["Robbie", "Marcquis", "Christopher", "Yasir"]]
"Codie"	[2, ["Harjeevan", "Nickhill"]]
"Cody"	[6, ["Blaike", "Jayden-Thomas", "Tanay", "Anndra", "Saghun", "Corie"]]
"Cody-Lee"	[8, ["Joojo", "Che", "Rihan", "Kyrillos", "Airlie", "Ma'moon", "Nathanael", "Shawn"]]
"Coel"	[3, ["Anay", "Hadyn", "Jarl"]]
"Cohan"	[3, ["Rhys", "Symon", "Kamran"]]
"Cohen"	[7, ["Tobey", "Brooklyn", "Maison", "Johnnie", "Muzzammil", "Seumas", "Eljay"]]
"Colby"	[5, ["Amaan", "Maxwell", "Devin", "Zarran", "Lewis"]]
"Cole"	[5, ["Fiachra", "Carlo", "Addisson", "Vithujan", "Seaan"]]
"Colin"	[4, ["Roray", "Muhsin", "Edwyn", "Jadyn"]]
"Coll"	[2, ["Denzel", "Bader"]]
"Colm"	[4, ["Areez", "Eadie", "Bradley", "Luke"]]
"Colt"	[3, ["Yuanyu", "Cieran", "Alex"]]
"Colton"	[6, ["Ayman", "Kiran", "Salman", "Nidhish", "Euan", "Cain"]]
"Colum"	[4, ["Anubhav", "Laison", "Bo", "Yakup"]]
"Colvin"	[5, ["Sheigh", "Neshawn", "Alanas", "Tristan", "Ireayomide"]]
"Comghan"	[6, ["Dion", "Ramsay", "Jaxson", "Ziyaan", "Hansen", "Lock"]]
"Conal"	[6, ["Karol", "Orson", "Richey", "Kyle", "Forgan", "Darrel"]]
"Conall"	[4, ["Emerson", "Jonatan", "Tomasz", "Rafal"]]
"Conan"	[4, ["Kallan", "Sung", "Conlin", "Dhavid"]]
"Conar"	[5, ["Sebastien", "Johannes", "Adrien", "Hugo", "Danyal"]]
"Conghaile"	[2, ["Cole", "Brian"]]
"Conlan"	[4, ["Banan", "Feden", "Henry", "Korbyn"]]
"Conley"	[3, ["Keiran", "Philippos", "Aristotelis"]]
"Conli"	[5, ["Kacper", "Clifford", "Sonneey", "Zacharias", "Azim"]]
"Conlin"	[4, ["Nilav", "Umair", "Caley", "Jedidiah"]]
"Conlon"	[4, ["Juan", "Axel", "Ishwar", "Caiden"]]
"Conlyn"	[1, ["Aarman"]]
"Connal"	[4, ["A-Jay", "Daryn", "Xiao", "Chi"]]
"Connall"	[4, ["Haiden", "Rajab-Ali", "Ennis", "Lliam"]]
"Connan"	[3, ["Michael", "Omri", "Kyden"]]
"Connar"	[3, ["Elliot", "Shadow", "Ahoua"]]
"Connel"	[1, ["Devon"]]
"Connell"	[5, ["Rheo", "Hopkin", "Kristian", "Adegbolahan", "Ola-Oluwa"]]
"Conner"	[5, ["Kellan", "Daniel-James", "Sean", "Jody", "Muneeb"]]
"Connolly"	[3, ["Mathew", "Lenon", "Farzad"]]
"Connor"	[1, ["Moosa"]]
"Connor-David"	[6, ["Eamon", "Peiyan", "Yusuf", "Alexx", "Keeman", "George"]]
"Conor"	[5, ["Justan", "Ayren", "Kit", "Harris", "Cairn"]]
"Conrad"	[4, ["Luca", "Moad", "Sam", "Jazib"]]
"Cooper"	[5, ["Lance", "Marcello", "Sher", "Josh", "Roan"]]
"Copeland"	[7, ["Ranolph", "Saad", "Hareem", "Eren", "Logan", "Kieran", "Ngonidzashe"]]
"Coray"	[4, ["Doire", "Ricky", "Oscar", "Mika"]]
"Corben"	[5, ["Nassir", "Bryson", "Malakhy", "Tomson", "Shaunpaul"]]
"Corbin"	[3, ["Conlyn", "Kalvin", "Russel"]]
"Corey"	[6, ["Kuba", "Oluwadamiloju", "Cavan", "Danys", "Aedin", "Husnain"]]
"Corey-James"	[5, ["Musse", "Tiylar", "Preston-Jay", "John", "Colm"]]
"Corey-Jay"	[6, ["Fergie", "Barkley", "Vince", "Ogheneruno", "Max", "Korrin"]]
"Cori"	[2, ["Thomson", "Msughter"]]
"Corie"	[5, ["Coban", "Dennys", "Ronan", "Ali", "Keiron"]]
"Corin"	[3, ["Faheem", "Hassan", "Niven"]]
"Cormac"	[4, ["Tegan", "Pawel", "Curtis", "Gavin-Lee"]]
"Cormack"	[2, ["Essa", "Aleksandr"]]
"Cormak"	[2, ["Caie", "Lorne"]]
"Corran"	[5, ["Kaydan", "Milos", "Xin", "Blazey", "Taonga"]]
"Corrie"	[5, ["Daumantas", "Jordyn", "Tre", "Manson", "Akan"]]
"Cory"	[2, ["Jasim", "Connor-David"]]
"Cosmo"	[2, ["Aidan", "Ian"]]
"Coupar"	[7, ["Quinn", "Tokinaga", "Conghaile", "Keo", "Ellisandro", "Bryan", "Leyton"]]
"Craig"	[3, ["Wabuya", "Jamal", "Olie"]]
"Craig-James"	[5, ["Joeddy", "Tieran", "Ehsan", "Arron", "Sean-Paul"]]
"Crawford"	[3, ["Mathuyan", "Coel", "Grady"]]
"Creag"	[4, ["Lyndsay", "Calum", "Abhinav", "Reiss"]]
"Crispin"	[3, ["Morgan", "Jesse", "Braiden"]]
"Cristian"	[4, ["Rohaan", "Justinas", "Ubaid", "Jace"]]
"Crombie"	[6, ["Jean-Lewis", "Modoulamin", "Harvey", "Cristian", "Samar", "Aran"]]
"Cruiz"	[2, ["Pasquale", "Rob"]]
"Cruz"	[6, ["Avi", "Rasmus", "Zubayr", "Sherwyn", "Cahl", "Niall"]]
"Cuillin"	[6, ["Binod", "Corey-Jay", "Sachkirat", "Francisco", "Tamiem", "Mikey"]]
"Cullen"	[3, ["Asrar", "Charly", "Darroch"]]
"Cullin"	[7, ["Emmanuel", "Lionel", "Khaleel", "Connan", "Torin", "Ryaan", "Zerah"]]
"Curtis"	[3, ["Syed", "Didier", "Cayden-Tiamo"]]
"Cyrus"	[5, ["Darach", "Mustapha", "Kenton", "Arya", "Sergio"]]
"D'arcy"	[1, ["Sung"]]
"Daanyaal"	[6, ["Dev", "Maximillian", "Stuart", "Ruan", "Colton", "Lewie"]]
"Daegan"	[4, ["Ferre", "Vinh", "Oisin", "Reo"]]
"Daegyu"	[2, ["Ronnie", "Armen"]]
"Dafydd"	[5, ["Kodie", "Babatunmise", "Alihaider", "Spencer", "Kaeden"]]
"Dagon"	[3, ["Samuela", "Dyllan-James", "Lukas"]]
"Dailey"	[3, ["Alessandro", "Youssef", "Geoff"]]
"Daimhin"	[4, ["Kinnon", "Louie", "Etienne", "Tymom"]]
"Daithi"	[4, ["Kaydn", "Sajjad", "Blue", "Jayse"]]
"Dakota"	[6, ["Jorryn", "Eoghan", "Trey", "Attila", "Manuel", "Shazil"]]
"Daksh"	[3, ["Cadon", "Kie", "Conrad"]]
"Dale"	[7, ["Orrick", "Maksymilian", "Kylan", "Bevin", "Aiden-Vee", "Tait", "Folarinwa"]]
"Dalong"	[4, ["Darrach", "Elyan", "Shannon", "Jon"]]
"Dalton"	[3, ["Amir", "Kalen", "Sullivan"]]
"Damian"	[4, ["Casper", "Arsalan", "Wallace", "Aditya"]]
"Damien"	[4, ["Timucin", "Brett", "Graham", "Ken"]]
"Damon"	[1, ["Kaidyn"]]
"Dan"	[2, ["Maaz", "Ebow"]]
"Danar"	[4, ["Phani", "Alfred", "Giacomo", "Deniss"]]
"Dane"	[5, ["Hasan", "Luciano", "Abdul", "Sambrid", "Uchenna"]]
"Danial"	[6, ["Dustin", "Latif", "Patrikas", "Christopher-Lee", "Kealon", "Mohamed"]]
"Daniel"	[6, ["Avraham", "Robbie", "Isak", "Jostelle", "Aled", "Kieron"]]
"Daniel-James"	[4, ["Airlie", "Otto", "Ilyaas", "Ma'moon"]]
"Daniels"	[3, ["Zhong", "Torrin", "Atal"]]
"Daniil"	[3, ["Wei", "Bennett", "Jarl"]]
"Danish"	[6, ["Hyden", "Kyan", "Aryankhan", "Maisum", "Ceiran", "Eljay"]]
"Daniyal"	[5, ["Comghan", "Kenzi", "Zayd", "Ruaridh", "Lewis"]]
"Danniel"	[4, ["Fikret", "Hong", "Addisson", "Kajally"]]
"Danny"	[5, ["Gjan", "Daniel", "Piotr", "Kelam", "Tiago"]]
"Dante"	[1, ["Lenny"]]
"Danyal"	[5, ["Callie", "Sandro", "Aref", "Dafydd", "Lukmaan"]]
"Danyil"	[4, ["Lawson", "Bradlie", "Eadie", "Yuri"]]
"Danys"	[4, ["Simon", "Tyra", "Nihaal", "Alex"]]
"Daood"	[4, ["Boab", "Drakeo", "Jaz", "Abaan"]]
"Dara"	[2, ["Yakup", "Sheigh"]]
"Darach"	[7, ["Caedyn", "Troy", "Hansen", "Lock", "Nevan", "Zohaib", "Eonan"]]
"Daragh"	[3, ["Karol", "Mickey", "Bharath"]]
"Darcy"	[4, ["Emerson", "Kevin", "Shaughn", "Darrel"]]
"Dareh"	[5, ["Rhuan", "Kallin", "Cathal", "Olurotimi", "Ksawery"]]
"Daren"	[3, ["Kendall", "Presley", "Murry"]]
"Darien"	[4, ["Jaidyn", "Roy", "Feden", "Odynn"]]
"Darius"	[7, ["Jez", "Motade", "Arjuna", "Henry", "Cameron", "Macaulay", "Sayad"]]
"Darl"	[2, ["Roman", "Keiran"]]
"Darn"	[3, ["Kade", "Caley", "Marzuq"]]
"Darrach"	[4, ["Archibald", "Bowie", "Cullen", "Lucus"]]
"Darragh"	[3, ["Dean", "Axel", "Robert"]]
"Darrel"	[2, ["Cormack", "Rayaan"]]
"Darrell"	[6, ["Kyrran", "Blaire", "Antoine", "Owen", "Franko", "Donald"]]
"Darren"	[3, ["Daryn", "Kia", "Jordon"]]
"Darrie"	[3, ["Andrei", "Dilano", "Connolly"]]
"Darrius"	[2, ["Oran", "Benoit"]]
"Darroch"	[3, ["Kenzo", "Leyland", "Toby"]]
"Darryl"	[5, ["Mayson", "Basile", "Rubhan", "Kale", "Olaoluwapolorimi"]]
"Darryn"	[4, ["Carrick", "Muneeb", "Hopkin", "Jody"]]
"Darwyn"	[5, ["Jago", "Zain", "Mathias", "Glenn", "Codie"]]
"Daryl"	[5, ["Valentino", "Hcen", "Kai", "Stefano", "Callun"]]
"Daryn"	[4, ["Yusuf", "Peiyan", "Keenan", "Eamonn"]]
"Daud"	[3, ["Alexx", "Martin", "Deelan"]]
"Daumantas"	[4, ["Harrison", "Moayd", "Aonghus", "Kit"]]
"Davi"	[4, ["Taylor-Jay", "Parker", "Roark", "Bobby"]]
"David"	[7, ["Dawid", "Marcello", "Caelen", "Turner", "Kieran", "Erencem", "Avani"]]
"David-Jay"	[5, ["Corey", "Zoubaeir", "Talorcan", "Anis", "Doire"]]
"David-Lee"	[7, ["Rico", "Ainsley", "Woyenbrakemi", "Darrie", "Francesco", "Charley", "Igor"]]
"Davie"	[5, ["Linden", "Conlyn", "Khai", "Zennon", "Raheem"]]
"Davis"	[2, ["Diarmid", "Kalvin"]]
"Davy"	[2, ["Kenneth", "Mahan"]]
"Dawid"	[2, ["Strachan", "Kainin"]]
"Dawson"	[4, ["Fergie", "Adain", "Camron", "Rennie"]]
"Dawud"	[4, ["Zachariya", "Armaan", "Coban", "Jiao"]]
"Dayem"	[4, ["Jacob", "Niven", "Sorley", "Urban"]]
"Daymian"	[3, ["Mohd", "Arda", "Dylan-Patrick"]]
"Deacon"	[5, ["Aleksandrs", "Pawlo", "Robi", "Laurence", "Youcef"]]
"Deagan"	[5, ["Kingston", "Rayane", "Harnek", "Nicodemus", "Aydan"]]
"Dean"	[2, ["Milosz", "Tarik"]]
"Deano"	[1, ["Rio"]]
"Decklan"	[6, ["Andy", "Jasim", "Connor-David", "Cade", "Rylay", "Hamish"]]
"Declain"	[4, ["Orlando", "Dillon", "Will", "Bernard"]]
"Declan"	[3, ["Radmiras", "Makin", "Aiden"]]
"Declyan"	[6, ["Rudi", "Ami", "Sukhvir", "Gurdeep", "Liall", "Mcbride"]]
"Declyn"	[5, ["Daniyal", "Joel", "Olie", "Rhian", "Sean-Paul"]]
"Dedeniseoluwa"	[6, ["Kelvan", "Zainedin", "Ross-Andrew", "Grady", "Ehsan", "Arron"]]
"Deecan"	[5, ["Konnor", "Allan-Laiton", "Oban", "Bailley", "Kaiden"]]
"Deegan"	[5, ["Reiss", "Heidar", "Lysander", "Morgyn", "Keeton"]]
"Deelan"	[4, ["Gerard", "Peregrine", "Clark", "Rohaan"]]
"Deklain-Jaimes"	[4, ["Nikita", "Kjae", "Ayyub", "Cristian"]]
"Del"	[2, ["Gallagher", "Yasin"]]
"Demetrius"	[3, ["Nicholas", "Aldred", "Isaac"]]
"Denis"	[1, ["Domenico"]]
"Deniss"	[3, ["Bjorn", "Airen", "Wylie"]]
"Dennan"	[6, ["Emmanuel", "Habeeb", "Zhen", "Nathan", "Shaurya", "Rahman"]]
"Dennin"	[4, ["Lionel", "Kames", "Oluwalayomi", "Fintan"]]
"Dennis"	[4, ["Darach", "Muzammil", "Maias", "Arya"]]
"Denny"	[3, ["Griffin", "Alyas", "T-Jay"]]
"Dennys"	[2, ["Barry", "Kris"]]
"Denon"	[8, ["Braydon", "Mack", "Muhammed", "Jincheng", "Edward", "Adam-James", "Keith", "Thrinei"]]
"Denton"	[4, ["Kael", "Denver", "Lennon", "Cobie"]]
"Denver"	[4, ["Daegan", "Usman", "Jenson", "Samy"]]
"Denzel"	[5, ["Pearse", "Areeb", "Braden", "Lawrence", "Geoffrey"]]
"Deon"	[2, ["Caileb-John", "Etienne"]]
"Derek"	[1, ["Antonyo"]]
"Derick"	[5, ["Manus", "Blyth", "Pacey", "Yago", "Ritchie"]]
"Derin"	[4, ["Ziya", "Tristain", "Josan", "Hamzah"]]
"Dermot"	[3, ["Ryleigh", "Angel", "Forbes"]]
"Derren"	[5, ["Elyan", "Cesare", "Nairn", "Darrach", "Malachai"]]
"Derrie"	[3, ["Kerr", "Liam-Stephen", "James"]]
"Derrin"	[5, ["Rhoridh", "Wallace", "Dharam", "Krzysiek", "Hubert"]]
"Derron"	[3, ["Ken", "Eidhan", "Briaddon"]]
"Derry"	[4, ["Zakaria", "Leonardo", "Derron", "Odhran"]]
"Derryn"	[4, ["Cambell", "Saunders", "Faysal", "Maaz"]]
"Deryn"	[5, ["Keilan", "Zach", "Jackie", "Phani", "Ed"]]
"Deshawn"	[5, ["Nikos", "Kacey", "Azedine", "Ezekiel", "Uilleam"]]
"Desmond"	[2, ["Dylan", "Jed"]]
"Dev"	[6, ["Garrett", "Patrikas", "Yassin", "Jostelle", "Robbie-lee", "Aled"]]
"Devan"	[4, ["Nicki", "Sahaib", "Raunaq", "Aarez"]]
"Devin"	[4, ["Jaydn", "Frankie", "Xander", "Chester"]]
"Devlin"	[7, ["Nathanial", "Jordan", "Manas", "Shawnpaul", "Darwyn", "Ilyaas", "Torsten"]]
"Devlyn"	[2, ["Szymon", "Hagun"]]
"Devon"	[4, ["Rhys-Bernard", "Hyden", "D'arcy", "Ceiran"]]
"Devrin"	[7, ["Guang", "Shaarvin", "Mykie", "Kenzi", "Lex", "Aryian", "Johnny"]]
"Devyn"	[5, ["Fikret", "Maxx", "Aman", "Kajetan", "Bartosz"]]
"Dex"	[4, ["Mackenzy", "Joash", "Seamas", "Daniele"]]
"Dexter"	[1, ["Codey"]]
"Dhani"	[6, ["Callin", "Kaelin", "Haydon", "Valen", "Norrie", "Reid"]]
"Dharam"	[6, ["Jerome", "Keelin", "Pedro", "Aref", "Geordan", "Lukmaan"]]
"Dhavid"	[5, ["Cillian", "Nihaal", "Layne", "Ayomide", "Yuri"]]
"Dhyia"	[6, ["Craig-James", "Harrington", "Kirk", "Jazeb", "Lovell", "Salter"]]
"Diarmaid"	[4, ["Yang", "Mitchell", "Pardeepraj", "Riyaj"]]
"Diarmid"	[6, ["Joseph", "Erdehan", "Davis", "Alasdair", "Shenuk", "Ramsey"]]
"Diarmuid"	[4, ["Karson", "Lockey", "Dissanayake", "Angus"]]
"Didier"	[5, ["Richie", "Forrest", "Windsor", "Malachy", "Darrell"]]
"Diego"	[4, ["Kevyn", "Nash", "Rafferty", "Tommi-Lee"]]
"Diesel"	[1, ["Jamey"]]
"Diesil"	[6, ["Kendyn", "Rhuan", "Selasi", "Murry", "Johansson", "Eisa"]]
"Digby"	[6, ["Colin", "Zaki", "Matthias", "Preston", "Leven", "Ruadhan"]]
"Dilan"	[3, ["Abu", "Macaulay", "Herbert"]]
"Dilano"	[2, ["Arjuna", "Damien"]]
"Dillan"	[5, ["Lenin", "Ronald", "Niraj", "Fahad", "Al-Hassan"]]
"Dillon"	[2, ["Umar", "Cullen"]]
"Dilraj"	[6, ["Pavit", "Teejay", "Aleksander", "Kearney", "Yoolgeun", "Robert-Gordon"]]
"Dimitri"	[3, ["Eshan", "Ayaan", "Tyler-James"]]
"Dinaras"	[4, ["Cormack", "Donald", "Aaron", "Blake"]]
"Dion"	[4, ["Kyrran", "Franko", "Rikki", "Immanuel"]]
"Dissanayake"	[2, ["Rajan", "Lloyd"]]
"Dmitri"	[4, ["Bentley", "Michael-Alexander", "Andrejs", "Florin"]]
"Doire"	[3, ["Shae", "Darien", "Nabeel"]]
"Dolan"	[7, ["Ameer", "Ze", "Mayson", "Leyland", "Devrin", "Jakub", "Rubin"]]
"Domanic"	[3, ["Rhett", "Hosea", "Vrishin"]]
"Domenico"	[4, ["Lenyn", "Tibet", "Efe", "Mungo"]]
"Domhnall"	[4, ["Bailey", "Jago", "Fauzaan", "Mathias"]]
"Dominic"	[5, ["Abdur-Rehmaan", "Daimhin", "Reily", "Callun", "Moray"]]
"Dominick"	[3, ["Martin", "Georgia", "Keenan"]]
"Dominik"	[2, ["Cal", "Kiya"]]
"Donald"	[2, ["Fynn", "Yannick"]]
"Donnacha"	[2, ["Isa", "Nial"]]
"Donnie"	[4, ["Raphael", "Turner", "Logann", "Kieran-Scott"]]
"Dorian"	[2, ["Rico", "Karthikeya"]]
"Dougal"	[6, ["Malcolm", "Shaun-Paul", "Buddy", "Emir", "Asim", "Jonothan"]]
"Douglas"	[2, ["Kalvyn", "Linden"]]
"Dougray"	[3, ["Mahdi", "Arunas", "Daood"]]
"Drakeo"	[6, ["Colt", "TJ", "Gregory", "Elias", "Mustafa", "Brogan"]]
"Dre"	[6, ["Reno", "Alvern", "Maxim", "Ohran", "Camron", "Fergus"]]
"Dregan"	[5, ["Thorben", "Arman", "Jiao", "Adain", "Machlan"]]
"Drew"	[2, ["Jacques", "Gil"]]
"Dugald"	[4, ["Urban", "Callahan", "Azzam", "Reggie"]]
"Duncan"	[4, ["Gene", "Ardal", "Pawlo", "Ciar"]]
"Duriel"	[3, ["Sidharth", "Declain", "Esteban"]]
"Dustin"	[5, ["Kingston", "Jayke", "Corrie", "Dorian", "Rayden"]]
"Dylan"	[4, ["Lachlann", "Akram", "Xue", "Tarik"]]
"Dylan-Jack"	[4, ["Kiaran", "Jorge", "Shayne", "Hamish"]]
"Dylan-James"	[2, ["Kareem", "Jaskaran"]]
"Dylan-John"	[4, ["Shane", "Riccardo", "Darl", "Will"]]
"Dylan-Patrick"	[5, ["Conlan", "Rudi", "Zeeshan", "Jameel", "Toluwalase"]]
"Dylin"	[6, ["Rhoan", "McCaulley", "Kristopher", "Oliver", "Kal-el", "Carwyn"]]
"Dyllan"	[5, ["Adil", "Arryn", "Joel", "Munmair", "Pranav"]]
"Dyllan-James"	[8, ["Zainedin", "Kaidinn", "Allan-Laiton", "Ross-Andrew", "Stephenjunior", "Bailley", "Leonard", "Cohan"]]
"Dyllon"	[4, ["Konnor", "Jesuseun", "Vasyl", "Lysander"]]
"Eadie"	[5, ["Clark", "Rohan", "Arian", "Leighton", "Easton"]]
"Eagann"	[5, ["Kjae", "Ayyub", "Kaan", "Nikodem", "Ewing"]]
"Eamon"	[5, ["Arandeep", "Abdisalam", "Harvie", "Lucca", "Reece"]]
"Eamonn"	[2, ["Dayem", "Christoph"]]
"Eason"	[5, ["Erik", "Rasul", "Cori", "Josiah", "Kierin"]]
"Eassan"	[2, ["Franciszek", "Wynn"]]
"Easton"	[2, ["Malikye", "Jonson"]]
"Ebow"	[2, ["Hadji", "Diego"]]
"Ed"	[5, ["Benji", "Ahmad", "Kurtis-Jae", "Rhyon", "Hussnain"]]
"Eddie"	[5, ["Aryan", "John-Michael", "Zane", "T-Jay", "Kenyon"]]
"Eden"	[3, ["Maximus", "Alyas", "Devan"]]
"Ediomi"	[2, ["Hogan", "Muhammed"]]
"Edison"	[2, ["Keivlin", "Alisdair"]]
"Eduardo"	[4, ["Babur", "Calley", "Rehan", "Denver"]]
"Eduards"	[5, ["Areeb", "Keegan", "Pearsen", "Abdulmalik", "Montague"]]
"Edward"	[3, ["Issiaka", "Alessio", "Lawrie"]]
"Edwin"	[5, ["Tymon", "Etinosa", "Raymond", "Nicolas", "Kinsey"]]
"Edwyn"	[3, ["Kaydyn", "Lagan", "Blyth"]]
"Eesa"	[6, ["Josan", "Kiefer", "Shea", "Eoin", "Aulay", "Caedan"]]
"Efan"	[3, ["Michee", "Dinaras", "Angel"]]
"Efe"	[2, ["Willum", "Chad"]]
"Ege"	[4, ["Kevan", "Nairn", "Ashton", "Zein"]]
"Ehsan"	[1, ["McKay"]]
"Ehsen"	[2, ["Murray", "Johann"]]
"Eiddon"	[4, ["Prentice", "Kenan", "Tiree", "Briaddon"]]
"Eidhan"	[5, ["Camerin", "Odhran", "Korben", "Fearghus", "Kaileb"]]
"Eihli"	[1, ["Mac"]]
"Eimantas"	[4, ["Kacey", "Zachariah", "Alfy", "Marwan"]]
"Eisa"	[3, ["Lucien", "Ezra", "Jedd"]]
"Eli"	[3, ["Garrett", "Lauchlan", "Kean"]]
"Elias"	[4, ["Marcus", "Caidan", "Kieryn", "Nicki"]]
"Elijah"	[7, ["Tanner", "Harlee", "Dominick", "Jaydn", "Kasper", "Corin", "Sahbian"]]
"Eliot"	[4, ["Shawnpaul", "Manas", "Owain", "AJ"]]
"Elisau"	[3, ["Butchi", "Raja", "Connell"]]
"Eljay"	[3, ["Jarno", "Benny", "Ceirin"]]
"Eljon"	[5, ["Myles", "Tobias", "Johnpaul", "Aryian", "Ahmed-Aziz"]]
"Elliot"	[5, ["Ruben", "Maxx", "Devlyn", "Lex", "Amani"]]
"Elliott"	[2, ["Hope", "Daniele"]]
"Ellis"	[5, ["Aron", "Munachi", "Glascott", "Leno", "Seamus"]]
"Ellisandro"	[3, ["Norrie", "Kaelum", "Derek"]]
"Elshan"	[5, ["Abdurraheem", "Callin", "Dagon", "Kohen", "Sandy"]]
"Elvin"	[5, ["Bradly", "Keelin", "Geordie", "Rodrigo", "Cillin"]]
"Elyan"	[4, ["Jura", "Nihal", "Abbas", "Raza"]]
"Emanuel"	[4, ["Luc", "Salvador", "Taylor", "Kayleb"]]
"Emerson"	[3, ["Lakshya", "Josese", "Yang"]]
"Emil"	[4, ["Erdehan", "Lockey", "Rana", "Corben"]]
"Emile"	[6, ["Karson", "Richie", "Bilal", "Miguel", "Fox", "Dmitri"]]
"Emir"	[3, ["Shaun", "Nasser", "Ailin"]]
"Emlyn"	[5, ["Lincoln-John", "Rupert", "Sunny", "McLay", "Ben"]]
"Emmanuel"	[3, ["Humza", "Finnean", "Warkhas"]]
"Emmet"	[3, ["Kendyn", "Ruadhan", "Brodie"]]
"Eng"	[4, ["Vinay", "Jaii", "Stewart", "Matthias"]]
"Eniola"	[4, ["Ediomi", "Moyes", "Damien", "Thomas-Jay"]]
"Enis"	[4, ["Keiren", "Brandon-Lee", "Phinehas", "Ronald"]]
"Ennis"	[3, ["Aziz", "Calib", "Regan"]]
"Enrico"	[3, ["Keatin", "Mohammed", "Cullin"]]
"Enrique"	[3, ["Isira", "Jubin", "Lauren"]]
"Enzo"	[5, ["Tyler-Jay", "Milo", "Killian", "Aaron-James", "Jayhan"]]
"Eoghain"	[5, ["Owyn", "Chibudom", "Tanzeel", "Donnacha", "Immanuel"]]
"Eoghan"	[3, ["Cadan", "Hamad", "Daud"]]
"Eoin"	[6, ["Lloyd", "Connor", "Orin", "Zijie", "Bentley", "Karamvir"]]
"Eonan"	[4, ["Shahmir", "Kyel", "Makenzie", "Asfhan"]]
"Erdehan"	[3, ["Jamaal", "Gurardass", "Kenzy"]]
"Eren"	[2, ["Baxter", "Vuyolwethu"]]
"Erencem"	[4, ["Brendyn", "Adenn", "Ege", "Macy"]]
"Eric"	[4, ["Cody", "Zaine", "Aliyaan", "Leo"]]
"Ericlee"	[3, ["Valery", "Abel", "Daithi"]]
"Eriz"	[3, ["Alexzander", "Tyson", "Deklain-Jaimes"]]
"Ernie-Jacks"	[7, ["Lucais", "Taylor-Lee", "Crispin", "Saman", "Mobeen", "Apisai", "Calan"]]
"Eroni"	[5, ["Pascoe", "Roary", "Isa", "Christian", "Landon"]]
"Eryk"	[6, ["Sheriff", "Zubair", "Eric", "Harikrishna", "Nial", "Logan-Rhys"]]
"Eshan"	[3, ["Francis", "Dolan", "Billy"]]
"Essa"	[4, ["Ainslie", "Emlyn", "Ridley", "Darrius"]]
"Esteban"	[5, ["Zeph", "Gytis", "Bully", "Rahil", "Linton"]]
"Ethan"	[1, ["Aeron"]]
"Etienne"	[1, ["Dara"]]
"Etinosa"	[3, ["Alvern", "Zamaar", "Struan"]]
"Euan"	[4, ["Jimmy", "Danar", "Arman", "Scot"]]
"Eugene"	[5, ["Pierce", "Jacques", "Muhamadjavad", "Coben", "Ronin"]]
"Evan"	[1, ["Soul"]]
"Evann"	[6, ["Daanyaal", "Dylin", "Momin", "Abdullah", "Teighen", "Ardal"]]
"Ewan"	[6, ["Robin", "Yousif", "Alekzander", "Sidney", "Ismail", "Ciar"]]
"Ewen"	[2, ["Corrie", "Aaryan"]]
"Ewing"	[4, ["Antonio", "Fred", "Jaymie", "Yadgor"]]
"Exodi"	[3, ["Atom", "Joris", "Shayne"]]
"Ezekiel"	[5, ["Dilraj", "Lochlan", "Hamza", "Ramanas", "Rylee"]]
"Ezra"	[6, ["Fodeba", "William", "Ibrahim", "Cesar", "Kyie", "Bertie"]]
"Fabian"	[5, ["Darn", "Ashlee-jay", "Nagib", "Zeeshan", "Bryce"]]
"Fahad"	[2, ["McCaulley", "Liam"]]
"Faheem"	[2, ["Sean-Ray", "Casey"]]
"Faisal"	[4, ["Zak", "Rossi", "Graeme", "Cohan"]]
"Faizaan"	[1, ["Obieluem"]]
"Famara"	[7, ["Maanav", "Daksh", "Peter", "Arian", "Theodore", "Abhisumant", "Jeswin"]]
"Fares"	[4, ["Azaan", "Rohan", "Jack", "Alfie"]]
"Farhaan"	[3, ["Cale", "Exodi", "Nikodem"]]
"Farhan"	[4, ["Mohamad", "Lasse", "Yasir", "Bogdan"]]
"Farren"	[3, ["Eriz", "Alec", "Avinash"]]
"Farzad"	[2, ["Domhnall", "Saghun"]]
"Fauzaan"	[3, ["Rihab", "Airidas", "Che"]]
"Favour"	[3, ["Nathanael", "Joojo", "Zhi"]]
"Fawaz"	[5, ["Ryan-Lee", "Anay", "Diesel", "Kamil", "Melville"]]
"Fawkes"	[3, ["Muzzammil", "Sethu", "Maison"]]
"Faysal"	[4, ["Lewin", "Ruaraidh", "Kenyon", "Devin"]]
"Fearghus"	[7, ["Addison", "Carl", "Vinnie", "Su", "Mackenzie", "Honey", "Kaiwen"]]
"Feden"	[3, ["Arnav", "Seaan", "JJ"]]
"Felix"	[3, ["Noor", "Alisdair", "Rooke"]]
"Fergal"	[2, ["Montague", "Hayden"]]
"Fergie"	[3, ["Cieran", "Bradley", "Geomer"]]
"Fergus"	[3, ["Harper", "Etinosa", "Tymoteusz"]]
"Ferre"	[1, ["Salman"]]
"Fezaan"	[8, ["Marc", "Sheafan", "Yahya", "Rivan", "David-Lee", "Alan", "Fruin", "Josef"]]
"Fiachra"	[3, ["Jaxon", "Caedan", "Kiefer"]]
"Filip"	[3, ["Kevan", "Sharoz", "Malachi"]]
"Filippo"	[5, ["Ammaar", "Conlin", "Rui", "Sultan", "Limo"]]
"Finan"	[4, ["Madox", "Walter", "Dante", "Finn"]]
"Findlay"	[2, ["Grant", "Sebastien"]]
"Findlay-James"	[3, ["Kailin", "Rowen", "Victor"]]
"Findlie"	[5, ["Eddie", "Camerin", "Aristotelis", "Dalton", "Jeyun"]]
"Finlay"	[1, ["Rokas"]]
"Finley"	[3, ["Calen", "Umair", "Haseeb"]]
"Finn"	[4, ["Keane", "Garry", "Teagan", "Cuillin"]]
"Finnan"	[3, ["Aleem", "Mario", "Christy"]]
"Finnean"	[3, ["Aarman", "Ravin", "Sahbian"]]
"Finnen"	[4, ["Blair", "Dominik", "Millar", "Chevy"]]
"Finnlay"	[5, ["Shay", "Ateeq", "Trafford", "Maneet", "Ajay"]]
"Finnley"	[1, ["Zhuo"]]
"Fintan"	[2, ["Ceirin", "Ahoua"]]
"Fionn"	[6, ["Kenzie", "Myles", "Tobias", "Aryn", "Zayn", "Qasim"]]
"Firaaz"	[4, ["Kalani", "Kriss", "Carrich", "Ola-Oluwa"]]
"Fletcher"	[6, ["Munachi", "Daniel-James", "Mackie", "Tian", "Adegbolahan", "Jock"]]
"Flint"	[5, ["Zaid", "Rorie", "Stefan", "Mathew", "Derek"]]
"Florin"	[5, ["Valentin", "Haydyn", "Abdur-Rahman", "Callum", "Kaelum"]]
"Flyn"	[5, ["Moore", "Geordie", "Yusef", "Layton", "Keeman"]]
"Flynn"	[6, ["Jura", "Evan", "Skye", "Roen", "Izaak", "Cillin"]]
"Fodeba"	[4, ["Jazib", "Aon", "Abbas", "Raza"]]
"Folarinwa"	[1, ["Marcel"]]
"Forbes"	[3, ["Zohair", "Eren", "Austin"]]
"Forgan"	[4, ["Jaydan", "Fox", "Talon", "Oscar"]]
"Forrest"	[3, ["Charles", "Nasser", "Wojciech"]]
"Fox"	[5, ["Amolpreet", "Zenith", "Guthrie", "Ruslan", "Brynmor"]]
"Francesco"	[2, ["Finnean", "Diarmaid"]]
"Francis"	[3, ["Eli", "Magnus", "Seonaidh"]]
"Francisco"	[5, ["Greg", "Levi", "Barkley", "Stewarty", "Coll"]]
"Franciszek"	[3, ["Heyden", "Ogheneochuko", "Vince"]]
"Franco"	[2, ["Msughter", "Zacharius"]]
"Frank"	[3, ["Niro", "Faheem", "Ronan"]]
"Frankie"	[7, ["Jeevan", "Abdulkarem", "Luis", "Tee-jay", "Dylan-John", "Regan", "Archie"]]
"Franklin"	[6, ["Cian", "Marius", "Yorgos", "Gavin", "Decklan", "Boyd"]]
"Franko"	[4, ["Siddhant", "Tyler-Jay", "Harman", "Nico"]]
"Fraser"	[3, ["Kayam", "Cormak", "Jayhan"]]
"Frazer"	[5, ["Jordyn", "Manolo", "Chidera", "Riley", "Akan"]]
"Fred"	[6, ["Hamad", "Connor", "Cadan", "Travis", "Lloyde", "Ralfs"]]
"Freddie"	[4, ["Kyel", "Flyn", "Ian", "Rian"]]
"Frederick"	[5, ["Johnson", "Quinn", "Darius", "Todd", "Asfhan"]]
"Fruin"	[1, ["Kaleb"]]
"Fyfe"	[4, ["Arrham", "Adenn", "Joeddy", "Findlay"]]
"Fyn"	[6, ["Ross", "Gordon", "Jaheim", "Munir", "Brendyn", "Kelso"]]
"Fynlay"	[6, ["Oakley", "Valery", "Bailie", "Reis", "Dermot", "Mathu"]]
"Fynn"	[3, ["Lyndsay", "Heddle", "Eason"]]
"Gabriel"	[3, ["Justinas", "Roger", "C-Jay"]]
"Gallagher"	[5, ["Ewen", "Crispin", "Calan", "Tyson", "Abdihakim"]]
"Gareth"	[4, ["Pascoe", "Landon", "Bodhan", "Tayo"]]
"Garren"	[8, ["Albert", "Kieren", "Roary", "Averon", "Joshua", "Isaa", "Sheriff", "Marco"]]
"Garrett"	[6, ["Domanic", "Caethan", "Corey-James", "Tamiem", "Zubayr", "Harikrishna"]]
"Garry"	[1, ["Wyatt"]]
"Gary"	[5, ["Shaun-Thomas", "Gytis", "Torin", "Rahim", "Aslam"]]
"Gavin"	[3, ["Amrit", "Mehraz", "Connall"]]
"Gavin-Lee"	[4, ["Johndean", "Cayden-Robert", "Arved", "Dara"]]
"Gene"	[8, ["Alvin", "Greig", "Ruairidh", "Levy", "Kensey", "Broghan", "Colton", "Maximilian"]]
"Geoff"	[3, ["Vincenzo", "Oilibhear", "Reo"]]
"Geoffrey"	[4, ["Danar", "Muhamadjavad", "Keison", "Pierce"]]
"Geomer"	[5, ["Azzedine", "Denton", "Masood", "Alieu", "Ronin"]]
"Geordan"	[4, ["Daanyaal", "Jensen", "Hately", "Faizaan"]]
"Geordie"	[1, ["Robin"]]
"George"	[2, ["Julian", "Ethan"]]
"Georgia"	[3, ["Mir", "Tariq-Jay", "Sajjad"]]
"Georgy"	[5, ["Freddie", "Al", "Pablo", "Blue", "Innes"]]
"Gerard"	[3, ["Joris", "Nelson", "Zishan"]]
"Ghyll"	[5, ["William", "Michat", "Rylee", "Orran", "Bertie"]]
"Giacomo"	[4, ["Elvin", "Cesar", "Ashley", "Tom"]]
"Gian"	[5, ["Zeid", "Rudy", "Kern", "Jameil", "Bryden"]]
"Giancarlo"	[7, ["Maddox", "Hristomir", "Kalen", "Aditya", "Walid", "Olivier", "Casey"]]
"Gianluca"	[4, ["Eiddon", "Brett", "Pravin", "Danniel"]]
"Gianmarco"	[3, ["Derrie", "Obosa", "Steve"]]
"Gideon"	[3, ["Abid", "Arihant", "Remo"]]
"Gil"	[3, ["Jacki", "Rohin", "Alfie"]]
"Gio"	[5, ["Nikolai", "Calean", "Kabeer", "Denis", "Reed"]]
"Girijan"	[7, ["Arann", "Jebadiah", "Samatar", "Kealon", "Abdul", "Lucian", "Patrick-John"]]
"Girius"	[6, ["Christopher", "Shiraz", "Robbie", "Alec", "Daymian", "Marcquis"]]
"Gjan"	[6, ["Harjeevan", "Loki", "Eriz", "Cai", "Saghun", "Corie"]]
"Glascott"	[2, ["Xabier", "Mikolaj"]]
"Glen"	[5, ["Darryn", "Atal", "Airlie", "Shawn", "Nathanael"]]
"Glenn"	[5, ["Ryan-Lee", "Symon", "Meshach", "Raith", "Hadyn"]]
"Gordon"	[1, ["Fionn"]]
"Grady"	[2, ["Puneetpaul", "Tobey"]]
"Graeme"	[5, ["Amaan", "Jakey", "Vithujan", "Krish", "Subhaan"]]
"Graham"	[6, ["Muhsin", "Thumbiko", "Mackenzie", "Addisson", "Honey", "Daniel"]]
"Grahame"	[6, ["Lenny", "Gjan", "Roray", "Pietro", "Coby", "Matej"]]
"Grant"	[1, ["Kofi"]]
"Grayson"	[2, ["Sanaullah", "Montgomery"]]
"Greg"	[3, ["Simon", "Lawson", "Roderick"]]
"Gregor"	[2, ["Loukas", "Harri"]]
"Gregory"	[4, ["Riyadh", "Chiron", "Bo", "Dougray"]]
"Greig"	[5, ["Marc", "Sheafan", "Ramsay", "Hansen", "Kiegan"]]
"Griffin"	[4, ["Mickey", "Angelo", "Bhaaldeen", "Jaxson"]]
"Griffyn"	[4, ["Kyle", "Wilson", "Darrel", "Malachi"]]
"Grzegorz"	[6, ["Lincoln", "Rafal", "Brydon-Craig", "Tomasz", "Ruo", "Narvic"]]
"Guang"	[5, ["Krzysztof", "James-Paul", "Waqaas", "Finn", "Ammar"]]
"Guerin"	[5, ["Madox", "Johannes", "Adrian", "Danyal", "Tisloh"]]
"Guillaume"	[5, ["Brian", "Cole", "Derry", "Stevie", "Presley"]]
"Gurardass"	[4, ["Damian", "Henry", "Ren", "Odin"]]
"Gurdeep"	[4, ["Zacharias", "Aristotelis", "Thom", "Motade"]]
"Gursees"	[5, ["Alhaji", "Dennin", "Kacper", "Clifford", "Umair"]]
"Gurthar"	[7, ["Abdulbasir", "Calen", "Cuillin", "Lucus", "Mohammad-Bilal", "Kobi", "Hashem"]]
"Gurveer"	[5, ["Yong", "Tee", "Ishwar", "Paul", "Bowen"]]
"Gurwinder"	[4, ["Dean", "Kile", "Shreyas", "Nickson"]]
"Gus"	[3, ["Cormac", "Miller", "Owais"]]
"Gustav"	[6, ["Ajay", "Shay", "Ateeq", "Kyron", "Xiao", "Daryn"]]
"Guthrie"	[6, ["Haiden", "Lliam", "Ennis", "Jarred", "Kia", "Andrei"]]
"Guy"	[6, ["Iagan", "Rhyse", "Taddy", "Micah", "Dilan", "Kyden"]]
"Gytis"	[3, ["Bruin", "Aryn", "Ahoua"]]
"Habeeb"	[4, ["Kalani", "Devon", "Leydon", "Mayeul"]]
"Hadji"	[4, ["Jody", "Adegbolahan", "Carrich", "Ola-Oluwa"]]
"Hadyn"	[4, ["Aronas", "Lenon", "Rorie", "Codie"]]
"Hagun"	[2, ["Mathew", "Callum"]]
"Haiden"	[3, ["Reilly", "Moosa", "Sanfur"]]
"Haider"	[6, ["Yusuf", "Skye", "Brady", "Cinar", "Alexei", "Peirce"]]
"Hamad"	[5, ["Luca", "Evan", "Reace", "Harris", "Tyrnan"]]
"Hamid"	[6, ["Lance", "Moad", "Bobby", "Fynlay", "Jazib", "Sam"]]
"Hamish"	[3, ["Davy", "Josh", "Marcello"]]
"Hamza"	[2, ["Zoubaeir", "Caelan"]]
"Hamzah"	[6, ["Kym", "Ricky", "Malakhy", "Bill", "Oscar", "Igor"]]
"Han"	[7, ["Asif", "Bryson", "Jonny", "Kez", "Zennon", "Emile", "Shaunpaul"]]
"Hansen"	[2, ["Suraj", "Meftah"]]
"Hao"	[3, ["Musse", "Rhudi", "Cavan"]]
"Hareem"	[5, ["Zakk", "Kenlin", "Tiylar", "Levi", "Eli"]]
"Hari"	[4, ["Campbell", "Deshawn", "Max", "Barkley"]]
"Harikrishna"	[7, ["Heyden", "Macaully", "Brandyn", "Ace", "Edison", "Damon", "Msughter"]]
"Haris"	[4, ["Lennan", "Mason", "Ronan", "Kadin"]]
"Harish"	[5, ["Regean", "Samual", "Faheem", "Azlan", "Umut"]]
"Harjeevan"	[4, ["Pawel", "Tee-jay", "Gavin-Lee", "Yorgos"]]
"Harjyot"	[5, ["Essa", "Judah", "Aleksandr", "Ayan", "Ismaeel"]]
"Harlee"	[6, ["Rayane", "Harman", "Milos", "Donnie", "Taonga", "Saifaddine"]]
"Harleigh"	[4, ["Daumantas", "Kaydan", "Manson", "Chidera"]]
"Harley"	[8, ["Shaye", "Ralfs", "Enrique", "Jordyn", "Tre", "Lloyde", "Cade", "Hamid"]]
"Harman"	[4, ["Wilkie", "Dillon", "Berkay", "Taegan"]]
"Harnek"	[6, ["Celik", "Johnson", "Aidan", "Darius", "Kyhran", "Ian"]]
"Harold"	[6, ["Rubyn", "Conghaile", "Gurdeep", "Bryan", "Zechariah", "Leyton"]]
"Haroon"	[5, ["Baye", "Devyn", "Howard", "Olie", "Wabuya"]]
"Harper"	[5, ["Joeddy", "Tieran", "Grady", "Arron", "Kelum"]]
"Harri"	[5, ["Mathuyan", "Leon", "Cody-Lee", "Jahid", "Zaineddine"]]
"Harrington"	[5, ["Favour", "Heddle", "Aria", "Konar", "Jesse"]]
"Harris"	[6, ["Keeton", "Zaaine", "Eassan", "Teydren", "Peni", "C-Jay"]]
"Harrison"	[4, ["Sohail", "Ewen", "Ubaid", "Justinas"]]
"Harry"	[3, ["Arafat", "Lucas", "Samar"]]
"Harvey"	[5, ["Pasquale", "Yaseen", "Rob", "Joshua", "Albie"]]
"Harvie"	[3, ["Kieren", "Sachkirat", "Cahl"]]
"Harvinder"	[3, ["Jayden-Lee", "Domanic", "Charly"]]
"Hasan"	[4, ["Emmanuel", "Asrar", "Khaleel", "Nate"]]
"Haseeb"	[4, ["Connall", "Rahim", "Ryaan", "Burak"]]
"Hashem"	[3, ["Finnley", "Oluwalayomi", "Wayde"]]
"Hashim"	[4, ["Lewie", "Eliot", "Prithvi", "Tjay"]]
"Hassan"	[4, ["Ferre", "Vinh", "Barrie", "Colton"]]
"Hassanali"	[3, ["Caolan", "Reo", "Hishaam"]]
"Hately"	[6, ["Gio", "Alihaider", "Cobi", "Lennon", "Masood", "Pierre-Antoine"]]
"Havila"	[4, ["Callan-Adam", "Noel", "Kodie", "Babatunmise"]]
"Hayden"	[2, ["Kedrick", "Momooreoluwa"]]
"Haydn"	[2, ["Rocco", "Ciaran"]]
"Haydon"	[4, ["Kinnon", "Cory", "Etienne", "Caileb-John"]]
"Haydyn"	[5, ["Freddie", "Antony", "Mirza", "Yago", "Tate"]]
"Hcen"	[1, ["Ala"]]
"Hector"	[10, ["Ramit", "Hamzah", "Conrad", "Lochlann", "Micheal", "Dimitri", "Ryleigh", "Tait", "Zishan", "Jason"]]
"Heddle"	[5, ["Shannon", "Ricco", "Cesare", "Bevin", "Aiden-Vee"]]
"Heidar"	[4, ["Kerr", "Gurthar", "Conley", "Tom"]]
"Heini"	[3, ["Finlay", "Jameil", "Olivier"]]
"Hendri"	[7, ["Rholmark", "Murdo", "Eiddon", "Casper", "Hubert", "Danny", "Arsalan"]]
"Henri"	[3, ["Leonardas", "Derrin", "Precious"]]
"Henry"	[1, ["Koray"]]
"Herbert"	[6, ["Zach", "Keigan", "Thiago", "Saul", "Ebow", "Arihant"]]
"Heyden"	[2, ["Jacki", "Deniss"]]
"Hiro"	[3, ["Hasan", "Uchenna", "Cruiz"]]
"Hirvaansh"	[5, ["Robbie", "Christopher-Lee", "Bohbi", "Yassin", "Patrick-John"]]
"Hishaam"	[3, ["Tyelor", "Shiraz", "Harjeevan"]]
"Hogan"	[6, ["Anselm", "Sahaib", "Lomond", "Tane", "Otto", "Dominic"]]
"Honey"	[4, ["Rihan", "Atal", "Darwyn", "Kyrillos"]]
"Hong"	[4, ["Torrin", "Zhong", "Connel", "Litrell"]]
"Hope"	[6, ["Rhys", "Oluwatoni", "Firaaz", "Diesil", "Wei", "Kamran"]]
"Hopkin"	[4, ["Brooklyn", "Johnny", "Ahmed", "Mykie"]]
"Hosea"	[3, ["Grzegorz", "Maxwell", "Kajally"]]
"Howard"	[7, ["Carlo", "Fikret", "Krishan", "Vithujan", "Reynold", "Daniel", "Hong"]]
"Howie"	[6, ["Lenny", "Arnold", "Edwyn", "Tiago", "Kelam", "Breandan"]]
"Hristomir"	[5, ["Kaelin", "Kogan", "Stanislaw", "Uzayr", "Deon"]]
"Hubert"	[4, ["Aref", "Dafydd", "Reid", "Lukmaan"]]
"Hugh"	[8, ["Cillian", "Deecan", "Marlon", "Yuanyu", "Keelan", "Bradlie", "Alex", "Geordan"]]
"Hugo"	[5, ["Loukas", "Kirk", "Rayyan", "Nihaal", "Simon"]]
"Humza"	[3, ["Kaydyne", "Craig", "Fyfe"]]
"Hunter"	[7, ["Riyadh", "Davie", "Sheigh", "Chris", "Laison", "Marc-Anthony", "Nevan"]]
"Husnain"	[5, ["Caedyn", "Jaxson", "Mickey", "Angus", "Kiegan"]]
"Hussain"	[4, ["Kyle-Derek", "Bhaaldeen", "Dissanayake", "Aidy"]]
"Hussan"	[4, ["Emerson", "Ashtyn", "Bryn", "Rafal"]]
"Hussnan"	[4, ["Ksawery", "Cathal", "Hugo", "Mael"]]
"I"	[4, ["Matthew-William", "Stevie", "Kain", "Victory"]]
"Iagan"	[3, ["Abu", "Keiran", "Jez"]]
"Iain"	[1, ["Philippos"]]
"Ian"	[7, ["Reeve", "Fabian", "Kade", "Niraj", "Azim", "Kobi", "Hashem"]]
"Ibraheem"	[5, ["Laughlan", "Yong", "Archibald", "Kearney", "Paul"]]
"Ibrahim"	[6, ["Juan", "Shyam", "Aleksandar", "Tyler-James", "Isimeli", "Eryk"]]
"Idahosa"	[4, ["Donald", "Cormack", "Sahil", "Anthony-John"]]
"Idrees"	[4, ["Owen", "Tanvir", "Iman", "Chi"]]
"Idris"	[5, ["Ennis", "Kia", "Nathan-Rae", "Zi", "Haider"]]
"Iestyn"	[7, ["Lliam", "Karam", "Taddy", "Connolly", "Andrei", "Jarvi", "Oran"]]
"Ieuan"	[5, ["Asa", "Daren", "Kye", "Majid", "Shae"]]
"Igor"	[6, ["Guillaume", "Elliott", "Kenzo", "Zayne", "Jakub", "Rubhan"]]
"Ihtisham"	[5, ["Suilven", "Mayson", "Devon", "Vrishin", "Olaoluwapolorimi"]]
"Ijay"	[6, ["Aden", "Kellen", "Daniels", "Prabhjoit", "Sean", "Efe"]]
"Ikechukwu"	[3, ["Rory", "Kai", "Codie"]]
"Ikemsinachukwu"	[5, ["Daimhin", "Sanfur", "Lyall", "Hcen", "Farzad"]]
"Ilyaas"	[4, ["Rogan", "Georgia", "Teos", "Eamonn"]]
"Ilyas"	[3, ["Tyrone", "Evann", "Kit"]]
"Iman"	[4, ["Abdallah", "Moayd", "Aonghus", "Creag"]]
"Immanuel"	[1, ["Bobby"]]
"Inan"	[5, ["Ranolph", "Zoubaeir", "Josh", "Erencem", "Turki"]]
"Indy"	[4, ["Francesco", "Bill", "Saad", "Karthikeya"]]
"Ines"	[7, ["Emir", "Ainsley", "Jonny", "Tomson", "Charley", "Asim", "Igor"]]
"Innes"	[6, ["Jaosha", "Linden", "Bryson", "Conlyn", "Amos", "Raheem"]]
"Ioannis"	[3, ["Oluwafemi", "Aedyn", "Husnain"]]
"Ireayomide"	[3, ["Tiylar", "Sephiroth", "Arun"]]
"Ireoluwa"	[3, ["Ogheneruno", "Alum", "Ruairi"]]
"Irvin"	[5, ["Camron", "Ace", "Vincent", "Jiao", "Dan"]]
"Irvine"	[2, ["Coban", "Ronan-Benedict"]]
"Isa"	[3, ["Regean", "Dennys", "Sorley"]]
"Isaa"	[2, ["Curtis", "Abdulkhader"]]
"Isaac"	[3, ["Jude", "Pawlo", "Ismaeel"]]
"Isaiah"	[4, ["Aarron", "Saim", "Loudon", "Tyllor"]]
"Isak"	[4, ["Kaydan", "Xue", "Ozzy", "Jay-Jay"]]
"Isher"	[2, ["Rio", "Athos-Carlos"]]
"Ishwar"	[4, ["Ralph", "Cade", "Taegen", "Connor-David"]]
"Isimeli"	[4, ["Kyhran", "Flynn", "Darl", "Bernard"]]
"Isira"	[3, ["Bryan", "Tokinaga", "Ellisandro"]]
"Ismaeel"	[3, ["Conghaile", "Mcbride", "Bayley"]]
"Ismail"	[2, ["Howie", "Rhian"]]
"Israel"	[3, ["Ross-Andrew", "Jahid", "Grady"]]
"Issiaka"	[5, ["Heidar", "Stephen", "Oban", "Bailley", "Kaiden"]]
"Ivan"	[4, ["Gerard", "Keeton", "Aria", "Dakota"]]
"Ivar"	[7, ["Ayub", "Rohaan", "Alfee", "Sohail", "Clark", "Jace", "Zaak"]]
"Izaak"	[3, ["Abdirahman", "Reece", "Aran"]]
"J"	[4, ["Pasquale", "Modu", "Boedyn", "Isaac"]]
"JJ"	[2, ["Ramone", "Neo"]]
"Jaay"	[3, ["Dayem", "Ericlee", "Sherwyn"]]
"Jac"	[6, ["Haris", "Corey-Jay", "Jayden-Lee", "Kash", "Saffi", "Zuriel"]]
"Jace"	[4, ["Kyran", "Ikechukwu", "Shaurya", "Wylie"]]
"Jack"	[5, ["Lionel", "Burak", "Connan", "Torquil", "Asrar"]]
"Jack-James"	[5, ["Promise", "Maximillian", "Jak", "Alyas", "Devan"]]
"Jacki"	[4, ["Fintan", "Kames", "Kurtis-Jae", "Meko"]]
"Jackson"	[6, ["Mack", "Kaison", "Reuben", "Oisin", "Adam-James", "Barrie"]]
"Jacky"	[4, ["Pierre-Antoine", "Muhammad", "Braydon", "Thrinei"]]
"Jacob"	[3, ["Alihaider", "Usman", "Babatunmise"]]
"Jacques"	[1, ["Daegan"]]
"Jad"	[2, ["Geoffrey", "Rocco"]]
"Jaden"	[8, ["Kinnon", "Etienne", "Julien", "Siergiej", "Nicolas", "Haroon", "Declyan", "Aydin"]]
"Jadon"	[5, ["Cosmo", "Douglas", "Pacey", "Blyth", "Aayan"]]
"Jadyn"	[4, ["Shea", "David-Jay", "Attila", "Ioannis"]]
"Jae"	[7, ["Jasper", "Eoghan", "Kie", "Ziya", "Tristain", "Ryleigh", "Cooper"]]
"Jagat"	[4, ["Angel", "Tait", "Rice", "Forbes"]]
"Jago"	[4, ["Kerr", "Malachai", "Tomas", "Ashton"]]
"Jaheim"	[2, ["Conli", "Zein"]]
"Jahid"	[4, ["Danny", "Finlay", "Rhoridh", "Sebastian"]]
"Jahy"	[4, ["Artem", "Murdo", "Tiree", "Ken"]]
"Jai"	[6, ["Odhran", "Allesandro", "Faysal", "Rowan", "Derrin", "Steven"]]
"Jai-Rajaram"	[3, ["Caidan", "Corin", "Aarez"]]
"Jaida"	[4, ["Abir", "Aristomenis", "Jevan", "Dalong"]]
"Jaiden"	[6, ["Gian", "Rohit", "Jackie", "Leiten", "Clayton", "Alfred"]]
"Jaidyn"	[6, ["Nikos", "Hasan", "Sol", "Kabir", "Azedine", "Klevis"]]
"Jaii"	[5, ["Aray", "Tayyib", "Kean", "Sambrid", "Dylan"]]
"Jaime"	[4, ["Isak", "Aled", "Awais", "Robbie-lee"]]
"Jaise"	[4, ["Chester", "Rihards", "Frank", "AJ"]]
"Jak"	[3, ["Hagun", "Khizar", "Ma'moon"]]
"Jake"	[3, ["Zhong", "Diesil", "Bennett"]]
"Jakey"	[5, ["D'arcy", "Hyden", "Maisum", "Johnny", "Rhys-Bernard"]]
"Jakob"	[4, ["Bruce", "Guang", "Tobi", "Eljon"]]
"Jaksyn"	[3, ["Vladimir", "Fikret", "Devlin"]]
"Jakub"	[3, ["Kelan", "Seamas", "Daniele"]]
"Jamaal"	[3, ["Deon", "Leno", "Stanley"]]
"Jamal"	[4, ["Sandro", "Lukmaan", "Farhan", "Abdur"]]
"Jameel"	[5, ["Cillian", "Jerome", "Layne", "Pedro", "Bradlie"]]
"Jameil"	[3, ["Rodrigo", "Sinai", "Nihaal"]]
"James"	[3, ["Jazeb", "Drakeo", "Abaan"]]
"James-Paul"	[3, ["Fyfe", "Alasdair", "Kayleb"]]
"Jamey"	[3, ["Zohaib", "Kienan", "Ramsey"]]
"Jamie"	[5, ["Forrest", "Miguel", "Bharath", "Dissanayake", "Angus"]]
"Jan"	[5, ["Richey", "Malachy", "Kyle-Derek", "Ailin", "Darrell"]]
"Jaosha"	[4, ["Conlly", "Lincoln-John", "Ammer", "Tommi-Lee"]]
"Jardine"	[3, ["Sunny", "Warkhas", "McLay"]]
"Jared"	[1, ["Titi"]]
"Jarell"	[4, ["Ruadhan", "Derryn", "Barath", "Stewart"]]
"Jarl"	[1, ["Victory"]]
"Jarno"	[4, ["Keiren", "Eden", "Ronald", "Thomas"]]
"Jarred"	[4, ["Aziz", "Dennis", "Koby", "Fahad"]]
"Jarvi"	[6, ["Teejay", "Mohammed", "Hashim", "Samir", "Kearney", "Abdulkadir"]]
"Jasey-Jay"	[8, ["Pavit", "Laughlan", "Shyam", "Marios", "Gary", "Aleksander", "Isimeli", "Chukwuemeka"]]
"Jasim"	[2, ["Aaron", "Axel"]]
"Jaskaran"	[2, ["Kyrran", "Saif"]]
"Jason"	[6, ["Chibudom", "Rikki", "Athol", "A-Jay", "Daud", "Shayaan"]]
"Jasper"	[9, ["Dilano", "Ryhs", "Kian", "Rajan", "Michael", "Connolly", "Jarvi", "Andrejs", "Cabhan"]]
"Jaxon"	[2, ["Wesley-Scott", "Tadhg"]]
"Jaxson"	[4, ["Quinlan", "Guillaume", "Elliott", "Nabeel"]]
"Jay"	[4, ["Leyland", "Devrin", "Olaoluwapolorimi", "Suilven"]]
"Jay-Jay"	[2, ["Linden", "Jonothan"]]
"Jaydan"	[5, ["Aden", "Mungo", "Seane", "Carrick", "Arran"]]
"Jayden"	[4, ["Cody", "Glenn", "Zaine", "Kellen"]]
"Jayden-James"	[2, ["Bailee", "Fauzaan"]]
"Jayden-Lee"	[5, ["Abdur-Rehmaan", "Lyle", "Keenan", "Bradyn", "Moray"]]
"Jayden-Paul"	[3, ["Georgia", "Jaay", "Sofian"]]
"Jayden-Thomas"	[3, ["Saman", "Harrison", "Kiya"]]
"Jaydn"	[2, ["Fynn", "Lancelot"]]
"Jaydon"	[3, ["Alber", "Caelen", "Erencem"]]
"Jaydyn"	[3, ["Talorcan", "Mikael", "Jayden"]]
"Jayhan"	[3, ["Francis", "Osesenagha", "Kynan"]]
"Jayke"	[3, ["Benedict", "Kurt", "Warrick"]]
"Jaymie"	[5, ["Arunas", "TJ", "Mahdi", "Elias", "Aedyn"]]
"Jayse"	[6, ["Zamaar", "Prinay", "Kenneth", "Alum", "Levon", "Jai-Rajaram"]]
"Jayson"	[2, ["Vincent", "Camron"]]
"Jaz"	[7, ["Scot", "Thorben", "Keiryn", "Arman", "Gil", "Jiao", "Dan"]]
"Jazeb"	[3, ["Lennen", "Kadyn", "Dennys"]]
"Jazib"	[1, ["Faisal"]]
"Jazz"	[3, ["Pawlo", "Laurie", "Ismail"]]
"Jean"	[7, ["Sidharth", "Aleksandrs", "Nicol", "Tylor", "Rayden", "Jude", "Cailaen"]]
"Jean-Lewis"	[4, ["Saim", "Milosz", "Harnek", "Loudon"]]
"Jean-Pierre"	[5, ["Chimsom", "Indy", "Davi", "Jorge", "Shayne"]]
"Jebadiah"	[4, ["Atli", "Neil", "Enzo", "Conor"]]
"Jed"	[4, ["Taegen", "Jaskaran", "Andy", "Will"]]
"Jedd"	[4, ["Elshan", "Maksim", "Jole", "Ashlee-jay"]]
"Jedidiah"	[6, ["Dex", "Rudi", "Ami", "Sukhvir", "Jameel", "Gursees"]]
"Jeemie"	[4, ["Maddison", "Oliver", "Wai", "Bayley"]]
"Jeevan"	[4, ["Bret", "Ehsen", "Munmair", "Pranav"]]
"Jeffrey"	[6, ["Obieluem", "Allan-Laiton", "Stephenjunior", "Bailley", "Vasyl", "Mati"]]
"Jensen"	[6, ["Heidar", "Santino", "Konnor", "Daksh", "Calum-James", "Easton"]]
"Jenson"	[4, ["Clark", "Leighton", "Kehinde", "Theo"]]
"Jensyn"	[4, ["Demetrius", "Ubayd", "Kjae", "Ayyub"]]
"Jeremy"	[4, ["Kealan", "Modu", "Aran", "Gallagher"]]
"Jerome"	[1, ["Shiloh"]]
"Jeronimo"	[5, ["Erik", "Jayden-Paul", "Cori", "Harish", "Kierin"]]
"Jerrick"	[6, ["Rihab", "Kyran", "Franciszek", "Ikechukwu", "Domenico", "Wynn"]]
"Jerry"	[2, ["Emmet", "Ata"]]
"Jesse"	[5, ["Diego", "Benji", "Ryan", "Melville", "Hadji"]]
"Jesuseun"	[6, ["Daragh", "Ceejay", "Ahmad", "Maias", "Seth", "Wayne"]]
"Jeswin"	[6, ["Muzammil", "Promise", "Ruaraidh", "Zane", "Lewin", "Kenyon"]]
"Jevan"	[4, ["Kris", "Carl", "Alyas", "Kaison"]]
"Jeyun"	[3, ["Keivlin", "Addison", "JJ"]]
"Jez"	[3, ["Cobie", "Masson", "Braydon"]]
"Jia"	[4, ["Kael", "Babur", "Nolan", "Hayden"]]
"Jian"	[3, ["Jensyn", "Geoffrey", "Lawrence"]]
"Jiao"	[3, ["Roddy", "Etinosa", "Marley"]]
"Jimmy"	[4, ["Jayson", "Raymond", "Aayan", "Cosmo"]]
"Jincheng"	[6, ["Chiqal", "Yahya", "Padraig", "Blyth", "Frederick", "Ioannis"]]
"Joaquin"	[2, ["Michee", "Orrick"]]
"Joash"	[3, ["Idrees", "Darragh", "Forbes"]]
"Jock"	[2, ["Conli", "James"]]
"Jody"	[3, ["Krzysiek", "Dharam", "Kalin"]]
"Joe"	[4, ["Madison-Jake", "Tiree", "Sebastian", "Adnan"]]
"Joeddy"	[2, ["Derron", "Zakariya"]]
"Joel"	[2, ["Korben", "Balian"]]
"Joey"	[3, ["Keilan", "Thierry", "Zachariah"]]
"Joey-Jack"	[7, ["Azeem", "Nikos", "Marwan", "Kacey", "Dennan", "Uilleam", "Rohit"]]
"Johann"	[3, ["Rees", "Sameer", "Teagan"]]
"Johannes"	[1, ["Lauchlan"]]
"Johansson"	[6, ["Caidan", "Kieryn", "Aarez", "Lorcan", "Ravin", "Nicki"]]
"John"	[4, ["Dominick", "Owain", "Frankie", "Corin"]]
"John-Michael"	[6, ["Shaarvin", "Myles", "Tobias", "Kenzi", "Aryian", "Maitlind"]]
"John-Paul"	[7, ["Callin", "Mateusz", "Valen", "Derek", "Farren", "Norrie", "Kaelum"]]
"John-Scott"	[4, ["Abdurraheem", "Jerome", "Teodor", "Keelin"]]
"Johnathan"	[5, ["Shawnpaul", "Manas", "Ilyas", "Nathaniel", "Rihards"]]
"Johndean"	[3, ["Ryder", "Torsten", "Andreas"]]
"Johnjay"	[7, ["Rhys-Bernard", "Szymon", "Benny", "Wen", "Omar", "Kyde", "Ahmed-Aziz"]]
"Johnnie"	[5, ["Basher", "Amani", "Zayn", "Conal", "Sudais"]]
"Johnny"	[5, ["Joash", "Aron", "Carlos", "Hope", "Vladimir"]]
"Johnpaul"	[4, ["Piotr", "Zaid", "Rori", "Jae"]]
"Johnson"	[4, ["Geordie", "Cillin", "Rodrigo", "Layne"]]
"Jole"	[2, ["Caine", "Tyree"]]
"Jomuel"	[6, ["Dre", "Jazeb", "Lakshya", "Aon", "Kayleb", "Yang"]]
"Jon"	[3, ["Erdehan", "Josese", "Marcel"]]
"Jon-Paul"	[5, ["Herbert", "Campbel", "Kori", "Deryn", "Reng"]]
"Jonah"	[4, ["Lockey", "Zohair", "Cael", "Dmitri"]]
"Jonatan"	[1, ["Ieuan"]]
"Jonathan"	[5, ["Rafferty", "Shaun", "Tommy", "Brynmor", "Gustav"]]
"Jonathon"	[5, ["Kalum", "Diarmaid", "Sunny", "Conlon", "Oluwadamilare"]]
"Jonny"	[3, ["Murry", "Cator", "Johansson"]]
"Jonson"	[5, ["Abubakar", "Sayeed", "Macaulay", "Jia", "Moyes"]]
"Joojo"	[3, ["Aziz", "Cobain", "Zacharie"]]
"Jordan"	[6, ["Calib", "Koby", "Luic", "Jeemie", "Niro", "Fahad"]]
"Jordi"	[1, ["Teejay"]]
"Jordon"	[6, ["Tyler-Jay", "Siddhant", "Nico", "Deano", "Aleksander", "Isira"]]
"Jordy"	[3, ["Harley", "Milo", "Antoine"]]
"Jordyn"	[4, ["Chibudom", "Manolo", "Immanuel", "Ajayraj"]]
"Jorge"	[6, ["Athon", "Zidane", "Enrico", "Jordy", "Travis", "Nawfal"]]
"Joris"	[5, ["Ryhs", "Wiktor", "Bentley", "Andrejs", "Florin"]]
"Jorryn"	[6, ["Darien", "Toby", "Asfhan", "Aiadan", "Iain", "John-Scott"]]
"Josan"	[4, ["Brunon", "Jamaal", "Leylann", "Gurardass"]]
"Josef"	[5, ["Kaleb", "Kristin", "Finan", "Rheyden", "Carson"]]
"Joseph"	[5, ["Arrham", "Brendon", "Daniil", "Seane", "Joe"]]
"Josese"	[5, ["Fauzaan", "Bailey", "Kaid", "Mathu", "Jaheim"]]
"Josh"	[5, ["Argyll", "Valery", "Reily", "Jerry", "Sanjay"]]
"Joshiah"	[7, ["Alexzander", "Keenan-Lee", "Terry", "CJ", "Bradyn", "Leigh", "Yves"]]
"Josiah"	[4, ["Apisai", "Pascoe", "Bobby-Lee", "Drew"]]
"Joss"	[4, ["Fynn", "Sheriff", "Roary", "Averon"]]
"Jostelle"	[4, ["Jayden-James", "Corey", "Logan-Rhys", "Kieran-Scott"]]
"Joynul"	[4, ["Dolan", "Charlie", "Kynan", "Ridley"]]
"Juan"	[3, ["Shaun-Paul", "Aslam", "Natan"]]
"Jubin"	[3, ["Gytis", "Sweyn", "Rahil"]]
"Judah"	[6, ["Kurt", "Benjamin", "Hussain", "Oluwafikunayomi", "Rhy", "Finnlay"]]
"Jude"	[5, ["Johndean", "Gregory", "Zamaar", "Levy", "Brogan"]]
"Jules"	[5, ["Ohran", "Ruairidh", "Kainui", "Baron", "Desmond"]]
"Julian"	[2, ["Kory", "Eduardo"]]
"Julien"	[4, ["Coben", "Brannan", "Jacques", "Pierce"]]
"Jun"	[5, ["Reggie", "Hately", "Faizaan", "Callan", "Denon"]]
"Junior"	[3, ["Brad", "Pearce", "Luka"]]
"Jura"	[1, ["Sidharth"]]
"Justan"	[3, ["Kinneil", "Loui", "Aaryan"]]
"Justin"	[3, ["Kayden", "Dorian", "Chin"]]
"Justinas"	[6, ["Trent", "Kiarash", "Atli", "Mantej", "David", "Shayne"]]
"Kaan"	[6, ["Dilraj", "Jaskaran", "Anees", "Michat", "Rylee", "Zion"]]
"Kabeer"	[4, ["Fodeba", "Orley", "Ibrahim", "Riccardo"]]
"Kabir"	[2, ["Zeeshan", "Ashlee-jay"]]
"Kacey"	[5, ["Dexter", "McCaulley", "Findlie", "Sulayman", "Casey"]]
"Kacper"	[2, ["Munro", "Daniyal"]]
"Kade"	[7, ["Stephenjunior", "Derrie", "Rossi", "Jahy", "Graeme", "Mati", "Cohan"]]
"Kaden"	[4, ["Daksh", "Konrad", "Fawkes", "Remigiusz"]]
"Kadin"	[3, ["Satveer", "Leighton", "Peter"]]
"Kadyn"	[3, ["Kabeer", "Marvellous", "Denis"]]
"Kaeden"	[5, ["Abdisalam", "Samatar", "Cale", "Lucian", "Reed"]]
"Kael"	[1, ["Isaiah"]]
"Kaelan"	[5, ["Erik", "Avinash", "Kiern", "Joss", "Harish"]]
"Kaelin"	[5, ["Domhnall", "Blaike", "Cori", "Tanay", "Saghun"]]
"Kaelum"	[4, ["Nathanael", "Darryl", "Che", "Wynn"]]
"Kai"	[4, ["Connar", "Emmet", "Hadji", "Khaya"]]
"Kaid"	[5, ["Ceejay", "Benn", "Hussnan", "Kyaan", "Wayne"]]
"Kaidan"	[4, ["Daragh", "Tobey", "Puneetpaul", "Maison"]]
"Kaiden"	[3, ["Griffyn", "Barry", "Kaiwen"]]
"Kaidinn"	[2, ["Rexford", "Krish"]]
"Kaidyn"	[4, ["Zack", "Braydyn", "Pieter", "Rooke"]]
"Kaileb"	[3, ["Alisdair", "Uzair", "Jadon"]]
"Kailin"	[5, ["Areez", "Abdul-Rehman", "Reice", "Montague", "Sanaullah"]]
"Kain"	[2, ["Marlin", "Ivan"]]
"Kaine"	[5, ["Tymoteusz", "Silas", "Etinosa", "Nidhish", "Aydon"]]
"Kainin"	[3, ["Anubhav", "Taylan", "Padraig"]]
"Kainui"	[4, ["Sheafan", "Ireayomide", "Eoin", "Josan"]]
"Kairn"	[1, ["Han"]]
"Kaison"	[4, ["Aidian", "Karl", "Bezalel", "Forgan"]]
"Kaiwen"	[4, ["Jonah", "Emanuel", "Gurwinder", "Kevan"]]
"Kajally"	[4, ["Zen", "Kallan", "Ollie", "Rui"]]
"Kajetan"	[2, ["Johann", "Rhuairidh"]]
"Kal-el"	[4, ["Lucien", "Nilav", "Umair", "Cuillin"]]
"Kalani"	[3, ["Eihli", "Kenan", "Zakariya"]]
"Kale"	[3, ["Ren", "Camerin", "Derron"]]
"Kaleb"	[4, ["Saunders", "Keir", "Aristotelis", "Thierry"]]
"Kaleem"	[5, ["Maryk", "Jack-James", "Giancarlo", "Zachariah", "Philip"]]
"Kalen"	[5, ["Teagan", "Jedd", "Patryk", "Garry", "Bony"]]
"Kalin"	[3, ["Mario", "Isher", "Kieryn"]]
"Kallan"	[4, ["Tanner", "Cormac", "Ravin", "Aarman"]]
"Kallin"	[3, ["Manas", "Rihonn", "Kasra"]]
"Kalum"	[5, ["Haiden", "Zhuo", "Enis", "Byron", "Torsten"]]
"Kalvin"	[4, ["Tadd", "Kane", "Fletcher", "Andreas"]]
"Kalvyn"	[7, ["Johnpaul", "Ceirin", "Rhyse", "I", "Dareh", "Elliot", "Kyde"]]
"Kameron"	[7, ["Jaksyn", "Mayeul", "Leydon", "Conal", "Kenzie", "Amani", "Bruin"]]
"Kames"	[4, ["Devlyn", "Rhein", "Adegbolahan", "Kajetan"]]
"Kamil"	[5, ["Kellan", "Daniel-James", "Porter", "Jock", "Seamus"]]
"Kamran"	[2, ["Badsha", "Stefan"]]
"Kamron"	[1, ["Reigan"]]
"Kane"	[4, ["Izaak", "Layton", "Peirce", "Bradly"]]
"Karam"	[4, ["Deegan", "Alexei", "Nihal", "Evan"]]
"Karamvir"	[3, ["Crawford", "Bob", "Jazib"]]
"Karandeep"	[2, ["Chris-Daniel", "Davy"]]
"Kareem"	[5, ["Ryszard", "Corben", "Kier", "Eren", "Zohair"]]
"Karim"	[4, ["Anir", "Fox", "Dmitri", "Wojciech"]]
"Karimas"	[4, ["Richie", "Malakai", "Aiman", "Tommy"]]
"Karl"	[3, ["Amolpreet", "Brynmor", "Ruslan"]]
"Karol"	[2, ["Magnus", "Hunter"]]
"Karson"	[7, ["Kenlin", "Arturo", "Greg", "Musa", "John", "Zakir", "Eli"]]
"Karsyn"	[4, ["Kaine", "Deryn", "Stewarty", "Coll"]]
"Karthikeya"	[4, ["Abubakar", "Sayeed", "Macauley", "Arlo"]]
"Kasey"	[5, ["Brandon-Lee", "Zacharius", "Thomas-Jay", "Ali", "Ediomi"]]
"Kash"	[7, ["Kaden", "Denny", "Faheem", "Mashhood", "Koddi", "Niro", "Regan"]]
"Kashif"	[6, ["Cullin", "Sami-Ullah", "Luis", "Dylan-John", "Pawel", "Archie"]]
"Kasim"	[5, ["Siddhant", "Marius", "Gavin", "Aleksandr", "Robert-Gordon"]]
"Kasper"	[4, ["Tyler-Jay", "Rayan", "Lorne", "Jayhan"]]
"Kasra"	[4, ["Anton", "Fraser", "Xin", "Riley"]]
"Kavin"	[1, ["Jordyn"]]
"Kayam"	[4, ["Michael-Alexander", "Dillan", "Connor", "Lloyde"]]
"Kaydan"	[1, ["Wiktor"]]
"Kayden"	[4, ["Todd", "Keo", "Conar", "Gurardass"]]
"Kaydin"	[3, ["Kristofer", "Baye", "Vuyolwethu"]]
"Kaydn"	[4, ["Adenn", "Madaki", "Daniil", "Sean-James"]]
"Kaydyn"	[3, ["Zaineddine", "Praise", "Leo"]]
"Kaydyne"	[6, ["Favour", "Lyndsay", "Valery", "Stefin", "Callyn", "Kaidan"]]
"Kayleb"	[1, ["Georgy"]]
"Kaylem"	[4, ["Niki", "Roger", "Sohaib", "Del"]]
"Kaylum"	[6, ["Harry", "Reean", "Kiyonari", "Tyson", "Samar", "Calan"]]
"Kayne"	[3, ["Christie", "Landon", "Pascoe"]]
"Kaywan"	[4, ["Joshua", "Eric", "Harikrishna", "Averon"]]
"Kealan"	[3, ["Sachkirat", "Zubayr", "Logan-Rhys"]]
"Kealon"	[2, ["Ijay", "Kyral"]]
"Kean"	[3, ["Connall", "Zerah", "Emlyn"]]
"Keane"	[6, ["Amrit", "Cayden-Robert", "Rhyan", "Sweyn", "Oluwafikunayomi", "Wasif"]]
"Kearney"	[4, ["Elijah", "Mahmoud", "Arved", "Dara"]]
"Keatin"	[5, ["Jaise", "Kairn", "Levy", "Maximilian", "Struan"]]
"Keaton"	[3, ["Vincenzo", "Reo", "Koushik"]]
"Keavan"	[3, ["Scott", "Muhamadjavad", "Keison"]]
"Keayn"	[3, ["Cobi", "Alieu", "Ronin"]]
"Kedrick"	[6, ["Kodie", "Samuela", "Hately", "Luka", "Abdul-Majeed", "Rehaan"]]
"Keegan"	[4, ["Keayn", "Yousif", "Lawlyn", "Israel"]]
"Keelan"	[4, ["Kinneil", "Aaryn", "Rayhan", "Sidney"]]
"Keelin"	[4, ["Pablo", "Mir", "Freddie", "Cory"]]
"Keeman"	[4, ["Manuel", "Lael", "Yadgor", "Nelson"]]
"Keenan"	[4, ["Lochlan", "Kiarash", "Anees", "Conrad"]]
"Keenan-Lee"	[3, ["Orran", "William", "Dimitri"]]
"Keeton"	[4, ["Ashley", "Nagib", "Aiden-Jack", "Darn"]]
"Kehinde"	[7, ["Beau", "Liam", "Kalen", "Sulayman", "Conley", "Jameil", "McKade"]]
"Keigan"	[5, ["Maddox", "Seb", "Walid", "Olivier", "Casey"]]
"Keilan"	[1, ["Brett"]]
"Keir"	[7, ["Vedantsinh", "Jai", "Obosa", "Fawkes", "Allen", "Matt", "Baillie"]]
"Keiran"	[3, ["Satveer", "Ebow", "Remo"]]
"Keiren"	[3, ["Peter", "Giacomo", "Sohan"]]
"Keiron"	[3, ["Azaan", "Kabeer", "Nikolai"]]
"Keiryn"	[3, ["Jebadiah", "Patrick-John", "Yasir"]]
"Keison"	[7, ["Nick", "Isaiah", "Christopher", "Shiraz", "Alec", "Eriz", "Marcquis"]]
"Keith"	[5, ["Raul", "Aaran", "Loki", "Jayden-Thomas", "Saghun"]]
"Keivlin"	[3, ["Franco", "Rihan", "Malo"]]
"Kelam"	[6, ["Torran", "Joojo", "Zhi", "Atal", "Shawn", "Nathanael"]]
"Kelan"	[5, ["Connar", "Benn", "Anay", "Diesel", "Kamil"]]
"Kellan"	[4, ["Kyaan", "Ahmed", "Sethu", "Hussnan"]]
"Kellen"	[5, ["Amaan", "Colvin", "Kenzeigh", "Eljay", "Lewis"]]
"Kelso"	[4, ["Vithujan", "Carlo", "Kaiwen", "Subhaan"]]
"Kelum"	[2, ["Muhsin", "Addisson"]]
"Kelvan"	[2, ["Alishan", "Bader"]]
"Kelvin"	[9, ["Jeremy", "Callie", "Kofi", "Abdul-Rehman", "Reice", "Noor", "Uzayr", "Sanaullah", "Dafydd"]]
"Ken"	[2, ["Areez", "Temba"]]
"Kenan"	[5, ["Marlin", "Dedeniseoluwa", "Jun", "Simon", "Euan"]]
"Kendall"	[3, ["Anubhav", "Salman", "Dougray"]]
"Kendyn"	[3, ["Chiron", "Yakup", "Laird"]]
"Kenlin"	[4, ["Josef", "Ramsay", "Ziyaan", "Caedan"]]
"Kenneth"	[4, ["Copeland", "Angelo", "Dion", "Forgan"]]
"Kensey"	[4, ["Jonatan", "Kyle", "Chaitanya", "Darrel"]]
"Kenton"	[6, ["Lincoln", "McKay", "Kevin", "Gurwinder", "Ammar", "Ruo"]]
"Kenzeigh"	[5, ["Sebastien", "Madox", "Grant", "Eihli", "Tisloh"]]
"Kenzi"	[3, ["Kailin", "Banan", "Lepeng"]]
"Kenzie"	[4, ["Dalton", "Aristotelis", "Victor", "Savin"]]
"Kenzo"	[5, ["Eddie", "Motade", "Thom", "Clifford", "Keir"]]
"Kenzy"	[5, ["Alhaji", "Maryk", "Calen", "Kobi", "Umair"]]
"Keo"	[3, ["Tee", "Sami", "Mohammad-Bilal"]]
"Ker"	[5, ["Juan", "Aleksandar", "Lauchlin", "Dean", "Garry"]]
"Kern"	[3, ["Ray", "Tyler", "Lorenz"]]
"Kerr"	[1, ["Tanvir"]]
"Kevan"	[2, ["Rihonn", "Iman"]]
"Kevin"	[3, ["Conner", "LLeyton", "Micah"]]
"Kevyn"	[3, ["Rhyse", "Ceiron", "Ahoua"]]
"Kez"	[2, ["Qirui", "Shadow"]]
"Khai"	[5, ["Filippo", "Suheyb", "Basile", "Ola-Oluwa", "Ambanimoh"]]
"Khalan"	[4, ["Sean", "Hopkin", "Carrich", "Kristian"]]
"Khaleel"	[2, ["Porter", "Jagat"]]
"Khaya"	[7, ["Stefan", "Valentin", "Haydyn", "Callum", "Kai", "Farzad", "Kole"]]
"Khevien"	[4, ["Eamon", "Lyall", "Teos", "Jeronimo"]]
"Khizar"	[7, ["J", "Deelan", "Nikash", "Skye", "Alexei", "Yusef", "Layton"]]
"Khizer"	[3, ["Luc", "Evan", "Cairn"]]
"Kia"	[4, ["Chrismedi", "Fynlay", "Irvine", "Moad"]]
"Kian"	[2, ["Alastair", "Eren"]]
"Kian-James"	[6, ["Karsyn", "Talon", "Zoubaeir", "Jaydan", "Bill", "Logan"]]
"Kiaran"	[4, ["Kym", "Aiman", "Charles", "Ricky"]]
"Kiarash"	[6, ["Asif", "Nassir", "Jonathon", "Bryson", "Conlyn", "Kez"]]
"Kie"	[5, ["Amolpreet", "Oluwadamiloju", "Bendeguz", "Ruslan", "Diarmid"]]
"Kiefer"	[3, ["Musa", "Rhudi", "Mahan"]]
"Kiegan"	[2, ["Colm", "Altyiab"]]
"Kienan"	[3, ["Campbell", "Barkley", "Kainin"]]
"Kier"	[7, ["Zacharius", "Jian", "Msughter", "Thomas-Jay", "Armaan", "Damon", "Phoenix"]]
"Kieran"	[6, ["Denny", "Jacob", "Faheem", "Niven", "Ronan", "Ali"]]
"Kieran-Scott"	[7, ["Jeevan", "Sami-Ullah", "Arda", "Umut", "Curtis", "Hassan", "Abdulkhader"]]
"Kieren"	[5, ["Cian", "Dylan-Patrick", "Boyd", "Robertjohn", "Pawel"]]
"Kierin"	[3, ["Siddharth", "Nicodemus", "Essa"]]
"Kiern"	[5, ["Oz", "Anton", "Jay-Jay", "Aarron", "Saifaddine"]]
"Kieron"	[7, ["Daumantas", "Shaye", "Rio", "Xin", "Frazer", "Manson", "Akan"]]
"Kieryn"	[3, ["Enrique", "Jasim", "Connor-David"]]
"Kile"	[3, ["Orlando", "Karandeep", "Kyhran"]]
"Killian"	[1, ["Johnson"]]
"Kimi"	[3, ["Sukhpal", "Conar", "Leyton"]]
"Kingston"	[3, ["Danish", "Madaki", "Olie"]]
"Kinneil"	[2, ["Kelum", "Grady"]]
"Kinnon"	[6, ["Favour", "Ross", "Oban", "Dermot", "Allan", "Mathuyan"]]
"Kinsey"	[5, ["Calum", "Eassan", "Reis", "Teydren", "Dakota"]]
"Kiran"	[2, ["Martyn", "Keeton"]]
"Kirk"	[1, ["Ubaid"]]
"Kirwin"	[3, ["Dugald", "Kaywan", "Gabriel"]]
"Kit"	[4, ["Dawud", "Albie", "Ericlee", "Isaa"]]
"Kiya"	[4, ["Zubayr", "Ty", "Rasmus", "Sachkirat"]]
"Kiyonari"	[6, ["Airen", "Charly", "Wylie", "Domanic", "Ridwan", "Kyral"]]
"Kjae"	[1, ["Habeeb"]]
"Klein"	[2, ["Ryaan", "Benjamyn"]]
"Klevis"	[4, ["Finnley", "Rhyan", "Kurtis", "Hussan"]]
"Kobe"	[5, ["Tjay", "Jaise", "Kenton", "Colton", "Eliot"]]
"Kobi"	[2, ["Ferre", "Vinh"]]
"Koby"	[3, ["Dane", "Thorfinn", "Reo"]]
"Koddi"	[1, ["Pierre-Antoine"]]
"Koden"	[6, ["Uri", "Callan-Adam", "Havila", "Noel", "Abdul-Majeed", "Rehaan"]]
"Kodi"	[4, ["Pearse", "Youssef", "Lawlyn", "Dyllan"]]
"Kodie"	[3, ["Rocco", "Israel", "Sidney"]]
"Kody"	[2, ["Cory", "Dougal"]]
"Kofi"	[3, ["Pacey", "Lael", "Tate"]]
"Kogan"	[3, ["Nelson", "Shazil", "Ramit"]]
"Kohen"	[3, ["Ryleigh", "Lochlann", "Tait"]]
"Kole"	[7, ["Idahosa", "Jon", "Ricco", "Maksymilian", "Ashley", "Naif", "William-John"]]
"Konan"	[4, ["Kerr", "Raegan", "Zeid", "Bryden"]]
"Konar"	[5, ["Sullivan", "Beinn", "Hubert", "Dhani", "McKade"]]
"Konnor"	[3, ["Murdo", "Joey-Jack", "Aditya"]]
"Konrad"	[3, ["Jai", "Graham", "Derrin"]]
"Koray"	[5, ["Vedantsinh", "Faysal", "Obosa", "Calvin", "Saul"]]
"Korben"	[3, ["Thiago", "Ebow", "Arihant"]]
"Korbyn"	[5, ["Azaan", "Kabir", "Marvin", "Ezekiel", "Uchenna"]]
"Korey"	[4, ["Dustin", "Luciano", "Kealon", "Sambrid"]]
"Kori"	[5, ["Robbie", "Isak", "Deacon", "Yassin", "Patrick-John"]]
"Korrin"	[6, ["Avraham", "Harjeevan", "Loki", "Jostelle", "Aaren", "Raunaq"]]
"Kory"	[4, ["Anselm", "Xabier", "Jayden-Thomas", "Otto"]]
"Koushik"	[4, ["Airlie", "Darryn", "Atal", "Shawn"]]
"Kris"	[4, ["Raithin", "Ryden", "Connel", "Butali"]]
"Krish"	[3, ["Oluwatoni", "Ahmed", "Kyan"]]
"Krishan"	[6, ["Grzegorz", "Johnnie", "Kenzeigh", "Tobi", "Seumas", "Pushkar"]]
"Kriss"	[4, ["Devlin", "Aman", "Bartlomiej", "Lewis"]]
"Kristian"	[3, ["Vithujan", "Arnold", "Seamas"]]
"Kristin"	[5, ["Lenny", "Gjan", "Codey", "Breandan", "Tiago"]]
"Kristofer"	[3, ["Matej", "Haydn", "Reid"]]
"Kristoffer"	[4, ["Aref", "Montgomery", "Bradlie", "Teo"]]
"Kristopher"	[2, ["Cillian", "Junior"]]
"Kruz"	[6, ["Harri", "Rayyan", "Kiran", "Tyra", "Abaan", "Cain"]]
"Krzysiek"	[2, ["Fyfe", "Aodhan"]]
"Krzysztof"	[5, ["Alanas", "Troy", "Ireoluwa", "Josef", "Eonan"]]
"Ksawery"	[3, ["Mickey", "Ramsay", "Rylie"]]
"Ksawier"	[4, ["Darrel", "Chaitanya", "Orson", "Richey"]]
"Kuba"	[6, ["Zendel", "Ashtyn", "Bryn", "Kevin", "Tommi-Lee", "Narvic"]]
"Kurt"	[3, ["Jamey", "Kallin", "McKenzie"]]
"Kurtis"	[5, ["Madox", "Johannes", "Selasi", "Hugo", "Danyal"]]
"Kurtis-Jae"	[3, ["Zakary", "Presley", "Roy"]]
"Kyaan"	[5, ["Renars", "Feden", "Banan", "Stevie", "Kain"]]
"Kyan"	[4, ["Macallum", "Motade", "Jez", "Gianluca"]]
"Kyde"	[3, ["Dennin", "Sonneey", "Clifford"]]
"Kyden"	[5, ["Sami", "Jedidiah", "Cullen", "Kobi", "Hashem"]]
"Kye"	[2, ["Dylan-James", "Chu"]]
"Kyel"	[3, ["Juan", "Dean", "Caiden-Paul"]]
"Kyhran"	[2, ["Kavin", "Donald"]]
"Kyie"	[3, ["Iman", "Jordon", "Chi"]]
"Kylan"	[6, ["Ennis", "Ryese", "Trafford", "Zi", "Athol", "Cabhan"]]
"Kylar"	[5, ["Benoit", "Michael", "Wesley-Scott", "Andrei", "Kyden"]]
"Kyle"	[4, ["Kenzo", "Majid", "Daren", "Shadow"]]
"Kyle-Derek"	[5, ["Guillaume", "Devon", "Leyland", "Ambanimoh", "Jakub"]]
"Kylian"	[7, ["Aden", "Macsen", "Hopkin", "Daniels", "Kristian", "Carrick", "Kalani"]]
"Kynan"	[2, ["Derick", "Kai"]]
"Kyral"	[2, ["Eamonn", "Daimhin"]]
"Kyran"	[1, ["Brady"]]
"Kyren"	[6, ["Ayrton", "Abdallah", "Justan", "Nikash", "Evann", "Tyrnan"]]
"Kyrillos"	[4, ["Jazz", "Bobby", "Moayd", "Aonghus"]]
"Kyro"	[2, ["Josh", "Dawid"]]
"Kyron"	[6, ["Jayden", "Caelen", "Kieran", "Erencem", "Corbin", "Turki"]]
"Kyrran"	[3, ["Doire", "Bill", "Mikael"]]
"LLeyton"	[5, ["Shyam", "Marios", "Aleksander", "Chukwuemeka", "Yoolgeun"]]
"Lachlainn"	[4, ["Darrie", "Jonny", "Nassir", "Emir"]]
"Lachlan"	[4, ["Conlyn", "Linden", "Zennon", "Surien"]]
"Lachlann"	[6, ["Oluwadamiloju", "Finnen", "Sephiroth", "Benedict", "Aedin", "Mahan"]]
"Lael"	[5, ["Arun", "Kenneth", "Gregor", "Colm", "Levon"]]
"Lagan"	[4, ["Max", "Vince", "Kainin", "Ruairi"]]
"Laird"	[4, ["Hiro", "Thomson", "Dan", "Sayf"]]
"Laison"	[1, ["Jacob"]]
"Lakshya"	[2, ["Azzam", "Luk"]]
"Lance"	[4, ["Arda", "Curtis", "Jeffrey", "Youcef"]]
"Lancelot"	[5, ["Siddharth", "Esteban", "Nicodemus", "Laurence", "Jude"]]
"Landon"	[3, ["Caie", "Milosz", "Antoni"]]
"Lang"	[6, ["Xue", "Lachlan", "Kaydan", "Indy", "Frazer", "Donnie"]]
"Lasse"	[2, ["Tre", "Hamid"]]
"Latif"	[4, ["Michael-James", "Dillon", "Rylay", "Connor-David"]]
"Lauchlan"	[3, ["Kyhran", "Ash", "Flynn"]]
"Lauchlin"	[3, ["Conghaile", "Jamal", "Ker"]]
"Laughlan"	[4, ["Ami", "Wabuya", "Olie", "Dex"]]
"Lauren"	[5, ["Danish", "Ehsan", "Arron", "Tiernan", "Kelum"]]
"Laurence"	[2, ["Stephen", "Pranav"]]
"Laurie"	[3, ["Bailie", "Santino", "Valo"]]
"Lawlyn"	[5, ["Peni", "Aria", "Clark", "Braiden", "Keeton"]]
"Lawrence"	[7, ["Nikita", "Ayub", "Martyn", "Demetrius", "Sohail", "Jace", "Ewing"]]
"Lawrie"	[2, ["Duncan", "Aran"]]
"Lawson"	[3, ["Yaseen", "Marcos", "Gallagher"]]
"Layne"	[2, ["Ty-Alexander", "Loghan"]]
"Layton"	[1, ["Jayden-Lee"]]
"Lee"	[4, ["Malikye", "Asrar", "Kyran", "Charly"]]
"Leigh"	[3, ["Lionel", "Amro", "Connan"]]
"Leigham"	[6, ["Kames", "Diego", "Syed", "Rhyley", "Benjamyn", "Hussnain"]]
"Leighton"	[2, ["Muzammil", "Arya"]]
"Leilan"	[2, ["Stuart", "Colum"]]
"Leiten"	[3, ["Scott-Alexander", "Jincheng", "Reuben"]]
"Leithen"	[4, ["Cobie", "Arnab", "Lennon", "Braydon"]]
"Leland"	[3, ["Kael", "Spencer", "Babatunmise"]]
"Lenin"	[3, ["Kedrick", "Lukas", "Areeb"]]
"Lennan"	[2, ["Pearse", "Ciaran"]]
"Lennen"	[4, ["Kinnon", "Etienne", "Julien", "Nicolas"]]
"Lennex"	[1, ["Antonyo"]]
"Lennon"	[4, ["Jorryn", "Chintu", "Innes", "Manus"]]
"Lennox"	[5, ["Jasper", "Ramit", "Dinaras", "Cadyn", "Lochlann"]]
"Lenny"	[2, ["Aiden-Vee", "Tait"]]
"Leno"	[5, ["Kerr", "Gurveer", "Ashton", "Darrach", "Tomas"]]
"Lenon"	[4, ["Finlay", "Dhani", "Sullivan", "James"]]
"Lenyn"	[2, ["Danny", "Casper"]]
"Leo"	[1, ["Jaida"]]
"Leon"	[5, ["Veeran", "Remy", "Faysal", "Cambell", "Hendri"]]
"Leonard"	[4, ["Phani", "Abir", "Saul", "Dalong"]]
"Leonardas"	[6, ["Zach", "Jacki", "Sol", "Deniss", "Kabir", "Rohit"]]
"Leonardo"	[5, ["Caleb", "Nikos", "Reegan", "Cruz", "Uilleam"]]
"Lepeng"	[5, ["Patrikas", "Arann", "Tayyib", "Kean", "Bohbi"]]
"Leroy"	[5, ["Isak", "Nickhill", "Tylar", "Marcus", "Deacon"]]
"Leven"	[6, ["Sahaib", "Lomond", "Jaydn", "Kasper", "Corin", "Raunaq"]]
"Levi"	[4, ["Darwyn", "Blaine", "Kyrillos", "AJ"]]
"Levon"	[2, ["Nathanial", "Eniola"]]
"Levy"	[3, ["Kyan", "Szymon", "Firaaz"]]
"Lewie"	[2, ["D'arcy", "Mykie"]]
"Lewin"	[5, ["Jakey", "Brooklyn", "Lex", "Zayd", "Comghan"]]
"Lewis"	[3, ["Vladimir", "Mackenzy", "Hong"]]
"Lex"	[4, ["Eesa", "Kelan", "Arnold", "Daniele"]]
"Leydon"	[4, ["Deon", "Leno", "Stanley", "Badr"]]
"Leyland"	[3, ["Jerome", "Kogan", "Lukmaan"]]
"Leylann"	[4, ["Cillian", "Bradlie", "Geordan", "Yuri"]]
"Leyton"	[2, ["Tyra", "Marlon"]]
"Liall"	[2, ["Craig", "Aodhan"]]
"Liam"	[5, ["Sheigh", "Davis", "Alasdair", "Laison", "Yang"]]
"Liam-Stephen"	[7, ["Caedyn", "Hao", "Erdehan", "Kienan", "Nevan", "Lockey", "Coray"]]
"Limo"	[6, ["Karol", "Jaxson", "Chang-Ha", "Windsor", "Taliesin", "Bharath"]]
"Lincoln"	[3, ["Malachy", "Nash", "Jonathan"]]
"Lincoln-John"	[5, ["Jamey", "Sunny", "Rafferty", "Dhyia", "Ammer"]]
"Lincon"	[6, ["Mael", "Warkhas", "Adrien", "Cator", "Olurotimi", "Humza"]]
"Linden"	[3, ["Selasi", "Leroy", "Johansson"]]
"Linton"	[4, ["Felix", "Ruadhan", "Alphonse", "Kain"]]
"Lionel"	[3, ["Abu", "Campbel", "Herbert"]]
"Lisandro"	[2, ["Phinehas", "Leland"]]
"Litrell"	[6, ["Dennis", "Reeve", "Hashim", "Niraj", "Umar", "Fahad"]]
"Liyonela-Elam"	[6, ["Luic", "Teejay", "Mohammed", "Gary", "Archibald", "Kearney"]]
"Lliam"	[3, ["Killian", "Antoine", "Jaydyn"]]
"Lloyd"	[5, ["Kyrran", "Owen", "Chibudom", "Rikki", "Immanuel"]]
"Lloyde"	[3, ["Daud", "Jordy", "Cabhan"]]
"Loche"	[8, ["Ryhs", "Zidane", "Michael", "Bentley", "Taddy", "Haider", "Dilano", "Andrejs"]]
"Lochlan"	[7, ["Daren", "Makensie", "Riach", "Iain", "John-Scott", "Oran", "Florin"]]
"Lochlan-Oliver"	[3, ["Carrick", "Finan", "Baxter"]]
"Lochlann"	[4, ["Conan", "Kenzo", "Bruno", "Quinlan"]]
"Lock"	[4, ["Aden", "Efe", "Macy", "Jody"]]
"Logan"	[6, ["Nyah", "Fauzaan", "Lyle", "Hcen", "Reily", "Kaid"]]
"Logan-Rhys"	[4, ["Alexx", "Justin", "CJ", "Tyrone"]]
"Logann"	[6, ["Argyll", "Yusuf", "Terry", "Jerrick", "Sanjay", "Eamonn"]]
"Loghan"	[4, ["Apisai", "Reagan", "Drew", "Abdalroof"]]
"Lokesh"	[5, ["Lancelot", "Taylor-Jay", "Fynn", "Marcin", "Kaylum"]]
"Loki"	[2, ["Joshiah", "Nial"]]
"Lomond"	[2, ["Osesenagha", "Anish"]]
"Lorcan"	[2, ["Asim", "Kynan"]]
"Lorenz"	[6, ["Linden", "Zeph", "Russel", "Buddy", "Guy", "Tony"]]
"Lorenzo"	[4, ["Diarmuid", "Warrick", "Mehmet", "Oluwafemi"]]
"Lorne"	[4, ["Johnathan", "Arunas", "TJ", "Daood"]]
"Loudon"	[3, ["Colt", "Gregory", "Jai-Rajaram"]]
"Loui"	[6, ["Reno", "Kory", "Camron", "Hiro", "Fergie", "Dan"]]
"Louie"	[4, ["Zachariya", "Mueez", "Coben", "Arman"]]
"Louis"	[6, ["Mason-Jay", "Sorley", "Dennys", "Jacques", "Kadyn", "Koden"]]
"Loukas"	[2, ["Hassanali", "Abdullah"]]
"Lovell"	[4, ["Aleksandrs", "Declain", "Keavan", "Youcef"]]
"Luc"	[1, ["Esteban"]]
"Luca"	[6, ["Antoni", "Ozzy", "Xue", "Kayden", "Milosz", "Dorian"]]
"Lucais"	[6, ["Indy", "Enzo", "Atli", "Akram", "Davi", "Neco"]]
"Lucas"	[4, ["Ralph", "Jaskaran", "Andy", "Zinedine"]]
"Lucca"	[6, ["Kareem", "Dilraj", "Ibraheem", "Taegen", "Kyie", "Bernard"]]
"Lucian"	[5, ["Makin", "Ashlee-jay", "Tokinaga", "Jole", "Shane"]]
"Luciano"	[5, ["Bayley", "Dex", "Ami", "Conghaile", "Kal-el"]]
"Lucien"	[5, ["Adil", "Arryn", "Maddison", "Findlay-James", "Wai"]]
"Lucus"	[2, ["Tiernan", "Breogan"]]
"Luic"	[1, ["Calum-James"]]
"Luis"	[3, ["Abhisumant", "Easton", "Braiden"]]
"Luk"	[6, ["Marvellous", "Kaan", "Demetrius", "Clark", "Rohan", "Soham"]]
"Luka"	[5, ["Abdirahman", "Cale", "Lucca", "Ubayd", "Samarjit"]]
"Lukas"	[3, ["Tayyab", "Aran", "Jean-Pierre"]]
"Lukasz"	[3, ["Ty-Alexander", "Robbi", "Avinash"]]
"Luke"	[2, ["Saffi", "Annan"]]
"Lukmaan"	[1, ["Malikye"]]
"Luqman"	[3, ["Shaurya", "Hadji", "Khaya"]]
"Lyall"	[4, ["Benji", "Jarell", "Amro", "Sylvain"]]
"Lyle"	[4, ["Rhyley", "Ahmad", "Elisau", "Maias"]]
"Lyndsay"	[4, ["Ruaraidh", "Griffin", "Colum", "T-Jay"]]
"Lysander"	[5, ["Carl", "Vinnie", "Kaison", "Su", "Hogan"]]
"Ma'moon"	[5, ["Rayaan", "Eshan", "Nicky", "Killian", "Caidyn"]]
"Maanav"	[6, ["Muhammed", "Arnab", "Scott-Alexander", "Keivlin", "Edward", "Adam-James"]]
"Maaz"	[6, ["Cobie", "Kael", "Lennox", "Denver", "Spondon", "Rooke"]]
"Mac"	[5, ["Calley", "Jensyn", "Hayden", "Abdulmalik", "Nolan"]]
"Macallum"	[3, ["Keegan", "Yu", "Braden"]]
"Macaulay"	[5, ["Tymon", "Julien", "Etinosa", "Alessio", "Marley"]]
"Macauley"	[4, ["Douglas", "Kaydn", "Jayse", "Cosmo"]]
"Macaully"	[7, ["Chiqal", "Ritchie", "Padraig", "David-Lee", "Shea", "Lagan", "Ioannis"]]
"Machlan"	[5, ["Josan", "Cadyn", "Ziya", "Tristain", "Cooper"]]
"Maciej"	[4, ["Willum", "Bezalel", "Ryley", "Karimas"]]
"Mack"	[2, ["Tomas", "Jonah"]]
"Mackenzie"	[4, ["Zein", "Conli", "Dharam", "Rui"]]
"Mackenzy"	[7, ["Madison-Jake", "Rhoridh", "Kalin", "Krzysiek", "Bekim", "Adnan", "Finley"]]
"Mackie"	[6, ["Murray", "Tiree", "Ken", "Sebastian", "Eidhan", "Briaddon"]]
"Macsen"	[5, ["Rowen", "Allister", "Derron", "Matteo", "Fearghus"]]
"Macy"	[2, ["Saunders", "Henri"]]
"Madaki"	[4, ["Jackie", "Keilan", "Thierry", "Zachariah"]]
"Maddison"	[3, ["Nikos", "Dennan", "Ezra"]]
"Maddox"	[4, ["Jed", "Aray", "Teagan", "Kean"]]
"Madison"	[3, ["Aled", "Awais", "Isher"]]
"Madison-Jake"	[5, ["Aarez", "Harjyot", "Jaydn", "Corin", "Tylar"]]
"Madox"	[4, ["Dominick", "Kasper", "Kyro", "Chevy"]]
"Mael"	[6, ["Manas", "Shawnpaul", "AJ", "Torsten", "Atapattu", "Nathaniel"]]
"Magnus"	[5, ["Ryder", "Kamron", "Szymon", "Hagun", "Liyonela-Elam"]]
"Mahan"	[3, ["Omar", "I", "D'arcy"]]
"Mahdi"	[2, ["Guang", "Zayn"]]
"Mahmoud"	[7, ["Kriss", "Maxx", "Filip", "Olaf", "Bartosz", "Amani", "Ruaridh"]]
"Maias"	[4, ["Rhein", "Hong", "Tian", "Daniele"]]
"Maison"	[3, ["Alistair", "Brehme", "Jae"]]
"Maisum"	[5, ["Reigan", "Callin", "Valen", "Kohen", "Lukmaan"]]
"Maitlind"	[4, ["Geordie", "Keelin", "Sandy", "Dagon"]]
"Majid"	[5, ["Jura", "Sinai", "Deecan", "Izaak", "Maros"]]
"Makensie"	[5, ["Kirk", "Harrington", "Aon", "Salvador", "Tyree"]]
"Makenzie"	[3, ["Lakshya", "Fyn", "Chris"]]
"Makin"	[3, ["Alasdair", "Cael", "Austen"]]
"Maksim"	[5, ["Corben", "Miguel", "Zohair", "Dmitri", "Lockey"]]
"Maksymilian"	[4, ["Kylian", "Fox", "Oryn", "Ailin"]]
"Malachai"	[3, ["Tommy", "Brynmor", "Rafferty"]]
"Malachi"	[7, ["Kalum", "Cator", "Sunny", "Oluwadamilare", "Ben", "Ammer", "Ksawier"]]
"Malachy"	[5, ["Kendyn", "Mael", "Seonaidh", "Humza", "Aedan"]]
"Malakai"	[7, ["Jaii", "Greg", "Matthias", "Derryn", "Brodie", "Ruadhan", "Coll"]]
"Malakhy"	[5, ["Damien", "Herbert", "Kaine", "Ogheneochuko", "Macaulay"]]
"Malcolm"	[6, ["Zacharie", "Arlo", "Sayeed", "Keiren", "Gianmarco", "Jia"]]
"Malik"	[5, ["Umer", "Clyde", "Mashhood", "Niro", "Fahad"]]
"Malikye"	[7, ["Calib", "Luic", "Cullin", "Reeve", "Mohammed", "Samir", "Jeemie"]]
"Malo"	[4, ["Teejay", "Robert-Gordon", "Marius", "Lauren"]]
"Manas"	[4, ["Owyn", "Blake", "Cormak", "Jayhan"]]
"Maneet"	[4, ["Chibudom", "Athon", "Lachlainn", "Shayan"]]
"Manmohan"	[4, ["Connor", "Zidane", "Andrejs", "Enrico"]]
"Manolo"	[4, ["Iain", "Dilano", "Orin", "Rian"]]
"Manson"	[4, ["Quinlan", "Asfhan", "Kenzy", "Nabeel"]]
"Mantej"	[1, ["Jamaal"]]
"Manuel"	[6, ["Hosea", "Adenn", "Kristin", "Vuyolwethu", "Rhett", "Joe"]]
"Manus"	[5, ["Arrham", "Leo", "Zaine", "Gordon", "Cody"]]
"Marc"	[2, ["Callyn", "Konan"]]
"Marc-Anthony"	[3, ["Abel", "Jerry", "Sanjay"]]
"Marcel"	[6, ["Alexzander", "Martin", "Georgia", "Jaay", "CJ", "Leigh"]]
"Marcello"	[2, ["Lucais", "Abdalroof"]]
"Marcin"	[6, ["Jean", "Fynn", "Drew", "Taylor-Lee", "Saman", "Yannick"]]
"Marco"	[3, ["Isa", "Turner", "Roary"]]
"Marcos"	[3, ["Jayden-James", "Raphael", "Anish"]]
"Marcous"	[4, ["Tamar", "Rico", "Ihtisham", "Kynan"]]
"Marcquis"	[4, ["Tony", "Buddy", "Emlyn", "Jonothan"]]
"Marcus"	[3, ["Diarmuid", "Linton", "Connal"]]
"Mario"	[6, ["Johndean", "Arunas", "Mahdi", "Dara", "Sergei", "Aedyn"]]
"Marios"	[4, ["Brogan", "Gregory", "Jai-Rajaram", "Kensey"]]
"Marius"	[5, ["Reno", "Alvern", "Caolain", "Baron", "Desmond"]]
"Mark"	[4, ["Jimmy", "Muhamadjavad", "Thorben", "Machlan"]]
"Marko"	[7, ["Mason-Jay", "Alieu", "Jacques", "Lennen", "Kadyn", "Zachary", "Coben"]]
"Markus"	[6, ["Samuel", "Faizaan", "Abdullah", "Urban", "Kodi", "Cyrus"]]
"Marley"	[1, ["Keavan"]]
"Marlin"	[5, ["Kinneil", "Robi", "Nicol", "Ethan", "Aydan"]]
"Marlon"	[4, ["Rayden", "Sajid", "Mir", "Cailaen"]]
"Maros"	[5, ["Ines", "Ozzy", "Kayden", "Mantej", "Chin"]]
"Marshall"	[3, ["Joris", "Zion", "Hamish"]]
"Martin"	[4, ["Jaskaran", "Bertie", "Anees", "Conor"]]
"Marty"	[5, ["Elshan", "Maksim", "Ashlee-jay", "Cesar", "Shane"]]
"Martyn"	[5, ["Amin", "Rudy", "Zeeshan", "Kern", "Bryce"]]
"Marvellous"	[3, ["Carwyn", "Kal-el", "Findlie"]]
"Marvin"	[5, ["Kelvan", "Joey", "Pravin", "Daniyal", "Sean-Ray"]]
"Marwan"	[6, ["Zak", "Obieluem", "Leonard", "Derrie", "Allen", "Cohan"]]
"Maryk"	[3, ["Maanav", "Vasyl", "Heini"]]
"Marzuq"	[6, ["Peregrine", "Rohan", "Jack", "Theodore", "Clarke", "Leighton"]]
"Mashhood"	[6, ["Marvellous", "Alfee", "Cale", "Kabeer", "Exodi", "Reed"]]
"Mason"	[3, ["Kealan", "Harvie", "Bogdan"]]
"Mason-Jay"	[6, ["Christopher", "Shiloh", "Aldred", "Joss", "Patrick", "Robbi"]]
"Masood"	[6, ["Erik", "Avinash", "Raul", "Lokesh", "Cori", "Harish"]]
"Masson"	[5, ["Domhnall", "Kashif", "Blaike", "Jayden-Paul", "Wynn"]]
"Matas"	[4, ["Shaw", "Joojo", "Airidas", "Rihab"]]
"Matej"	[5, ["Ryan", "Jarell", "Lisandro", "Sylvain", "Raith"]]
"Mateusz"	[5, ["Hussnan", "Benji", "Wayne", "Kamil", "Rhyon"]]
"Mathew"	[5, ["Tobey", "Muzzammil", "Elisau", "Griffyn", "Kenyon"]]
"Mathias"	[3, ["Ruaraidh", "Fezaan", "Devin"]]
"Mathu"	[3, ["Hogan", "Addison", "Krish"]]
"Mathuyan"	[2, ["Rooke", "Jadon"]]
"Mati"	[2, ["Matas", "Spondon"]]
"Matt"	[3, ["Te-Jay", "Bradley", "Pearsen"]]
"Matteo"	[2, ["Ciarian", "Roddy"]]
"Matthew"	[3, ["Rayne", "Nidhish", "Aazaan"]]
"Matthew-William"	[5, ["Yahya", "Rivan", "Padraig", "Fruin", "Laird"]]
"Matthias"	[4, ["Marc", "Alan", "Eoin", "Josan"]]
"Max"	[6, ["Ramone", "Dion", "Michee", "Ziyaan", "Ryley", "Copeland"]]
"Maxim"	[4, ["Bezalel", "Chad", "Kyle", "Orrin"]]
"Maximilian"	[5, ["Ashton-Lloyd", "Emanuel", "Jonah", "Kevan", "Zein"]]
"Maximillian"	[3, ["Krzysztof", "Walter", "James-Paul"]]
"Maximus"	[7, ["Madison-Jake", "Murray", "Sebastien", "Dante", "Johann", "Eihli", "Rhuairidh"]]
"Maxwell"	[5, ["Prentice", "Brian", "Zakariya", "Rowen", "Derron"]]
"Maxx"	[7, ["Balian", "Steven-lee", "Ren", "Mac", "Korben", "Fearghus", "Kaileb"]]
"Mayeul"	[7, ["Moshy", "Thierry", "Aristotelis", "Keir", "Dalton", "Zachariah", "Branden"]]
"Mayson"	[4, ["Azeem", "Dennan", "Kacey", "Clement"]]
"Mazin"	[4, ["Abdulbasir", "Jedd", "Kobe", "Aray"]]
"McCaulley"	[6, ["Shreyas", "Kieryn", "Awwal", "Mario", "Caiden", "Joynul"]]
"McKade"	[3, ["Anthony", "Owais", "Lorcan"]]
"McKauley"	[4, ["Jordi", "Kyro", "Chevy", "Rihonn"]]
"McKay"	[4, ["Ryder", "Haiden", "Enis", "Torsten"]]
"McKenzie"	[4, ["Omri", "Kyde", "Kamron", "Ceirin"]]
"McLay"	[3, ["Dareh", "Aryn", "Ahoua"]]
"Mcbride"	[2, ["Patryk", "Lauchlin"]]
"Meftah"	[7, ["Mayeul", "Devlyn", "Jakob", "Leydon", "Suheyb", "Guerin", "Qasim"]]
"Mehmet"	[7, ["Kriss", "Filip", "Hope", "Adegbolahan", "Carrich", "Ola-Oluwa", "Seamus"]]
"Mehraz"	[4, ["Munachi", "Efan", "Zaid", "Jock"]]
"Meko"	[4, ["Mateusz", "Badsha", "Farren", "Derek"]]
"Melville"	[3, ["Eagann", "Arfin", "Callum"]]
"Meshach"	[3, ["Izaak", "Cillin", "Yusef"]]
"Meyzhward"	[3, ["Jura", "Deegan", "Nihal"]]
"Micah"	[4, ["Jazib", "Aon", "Bob", "Kayleb"]]
"Michael"	[2, ["Alastair", "Davy"]]
"Michael-Alexander"	[1, ["Zohair"]]
"Michael-James"	[3, ["Charles", "Oryn", "Mika"]]
"Michal"	[5, ["Rafi", "Nasser", "Darren", "Shaun", "Ashwin"]]
"Michat"	[2, ["Amolpreet", "Conlon"]]
"Micheal"	[2, ["Aedan", "Hunter"]]
"Michee"	[4, ["Arturo", "Greg", "Ruaidhri", "Brodie"]]
"Mickey"	[3, ["Campbell", "Kaine", "Kori"]]
"Miguel"	[3, ["Heyden", "Jian", "Thomas-Jay"]]
"Mika"	[3, ["Ali", "Mashhood", "Gianmarco"]]
"Mikael"	[1, ["Luis"]]
"Mikee"	[5, ["Pavit", "Yorgos", "Gavin", "Mohanad", "Archie"]]
"Mikey"	[3, ["Judah", "Marius", "Essa"]]
"Mikhail"	[7, ["Anton", "Cormak", "Lorne", "Milo", "Rayan", "Jayhan", "Donnacha"]]
"Mikolaj"	[3, ["Blazej", "Fraser", "Ajayraj"]]
"Miles"	[5, ["Daumantas", "Hamad", "Enrico", "Zijie", "Travis"]]
"Millar"	[3, ["Michael-Alexander", "Karamvir", "Berkay"]]
"Miller"	[5, ["Nadeem", "Johnson", "Kyel", "Asfhan", "Makenzie"]]
"Milo"	[2, ["Quinn", "Rubin"]]
"Milos"	[5, ["Baye", "Mazin", "Howard", "Findlay", "Carson"]]
"Milosz"	[4, ["Joe", "Prabodhan", "Tieran", "Sean-James"]]
"Mir"	[1, ["Leo"]]
"Mirza"	[1, ["Abel"]]
"Mitch"	[7, ["Keenan-Lee", "Teydren", "Georgy", "Eason", "Moray", "Yves", "Pele"]]
"Mitchel"	[4, ["Alexzander", "Del", "Tyson", "Calan"]]
"Mitchell"	[3, ["Harry", "Dugald", "Abdihakim"]]
"Moad"	[4, ["Christie", "Landon", "Yannick", "Gabriel"]]
"Moayd"	[2, ["Joshua", "Logan-Rhys"]]
"Mobeen"	[6, ["Binod", "Francisco", "Kasey", "Wyatt", "Anmolpreet", "Oskar"]]
"Modoulamin"	[5, ["Malik", "Ridley", "Kyral", "Darrius", "Jonothan"]]
"Modu"	[4, ["Khalan", "Mehraz", "Zerah", "Gytis"]]
"Mohamad"	[6, ["Finnley", "Cayden-Robert", "Kameron", "Benjamin", "Rhyan", "Kurtis"]]
"Mohamed"	[7, ["Elijah", "Johndean", "Dara", "Greig", "Broghan", "Mustafa", "Arved"]]
"Mohammad"	[4, ["Alvern", "Levy", "Jaise", "Struan"]]
"Mohammad-Bilal"	[5, ["Jimmy", "Caolain", "Danar", "Fergus", "Reo"]]
"Mohammed"	[1, ["Lennex"]]
"Mohanad"	[7, ["Uri", "Faizaan", "Azzedine", "Rehaan", "Callan", "Alieu", "Kaeden"]]
"Mohd"	[5, ["Ardeshir", "Dyllan", "Teighen", "Keayn", "Brad"]]
"Momin"	[4, ["Yousif", "Jules", "Lawlyn", "Declan"]]
"Momooreoluwa"	[4, ["Sajid", "Nicolae", "Loui", "Ethan"]]
"Montague"	[7, ["Antonio", "Freddie", "Dougal", "Mir", "Pablo", "Yadgor", "Blessing"]]
"Montgomery"	[5, ["Kiarash", "Atom", "Eoghain", "Rishi", "Manuel"]]
"Monty"	[5, ["Anees", "Michat", "Cadon", "Ramanas", "Dimitri"]]
"Moore"	[2, ["Darn", "Ibrahim"]]
"Moosa"	[1, ["Liam"]]
"Moray"	[3, ["Amin", "Dexter", "Jameil"]]
"Morgan"	[2, ["Rholmark", "Danniel"]]
"Morgyn"	[5, ["Leonardas", "Allen", "Cohan", "Graham", "Matt"]]
"Morris"	[5, ["Kaidinn", "Obosa", "Calvin", "Konrad", "Steve"]]
"Morton"	[2, ["Keigan", "Maanav"]]
"Moshy"	[4, ["Kabeer", "Clarke", "Leilan", "Marvin"]]
"Motade"	[2, ["Samatar", "Reed"]]
"Moyes"	[3, ["Latif", "Bogdan", "Kealon"]]
"Msughter"	[4, ["Shiraz", "Daymian", "Nick", "Avraham"]]
"Mueez"	[6, ["Aaran", "Harjeevan", "Blaike", "Jayden-Thomas", "Anndra", "Saghun"]]
"Muhamadjavad"	[2, ["Xabier", "Darryn"]]
"Muhammad"	[4, ["Nathanael", "Khevien", "Litrell", "Raith"]]
"Muhammed"	[1, ["Diesel"]]
"Muhsin"	[5, ["Tobey", "Darcy", "Kenzeigh", "Ahmed", "Rhyon"]]
"Muir"	[5, ["Grzegorz", "Amaan", "Devin", "Ruari", "Lewis"]]
"Munachi"	[4, ["Addison", "Carlo", "Kaiwen", "Subhaan"]]
"Muneeb"	[5, ["Braydyn", "Thumbiko", "Edwin", "Joaquin", "Seaan"]]
"Mungo"	[2, ["Coby", "Noor"]]
"Munir"	[3, ["Areez", "Jeremy", "Callie"]]
"Munmair"	[4, ["Keelan", "Cieran", "Bradley", "Geomer"]]
"Munro"	[3, ["Rayne", "Cailin", "Kiran"]]
"Murdo"	[2, ["Anubhav", "Kaydyn"]]
"Murray"	[5, ["Marc", "Rivan", "Aulay", "Fruin", "Laird"]]
"Murrough"	[7, ["Ramsay", "Ziyaan", "Lock", "Rylie", "Tristan", "Jaxon", "Caedan"]]
"Murry"	[5, ["Bhaaldeen", "Dion", "Mickey", "Forgan", "Talha"]]
"Musa"	[2, ["Ashton-Lloyd", "Darrel"]]
"Musse"	[5, ["James-Paul", "Dhavid", "Ammar", "Ruo", "Kallan"]]
"Mustafa"	[6, ["Adrian", "Hugo", "Cathal", "Finn", "Believe", "Rhuairidh"]]
"Mustapha"	[9, ["Kendall", "Tisloh", "Brian", "Johannes", "Cole", "Eihli", "Arthur", "Murrough", "Lepeng"]]
"Muzammil"	[2, ["Korbyn", "Victor"]]
"Muzzammil"	[3, ["Macallum", "Abraham", "Savin"]]
"Mykie"	[5, ["Brandon", "Dennin", "Jack-James", "Keir", "Zacharias"]]
"Myles"	[4, ["Fabian", "Umair", "Reese", "Lucus"]]
"Mylo"	[3, ["Cuillin", "Garry", "Jedd"]]
"Nabeel"	[3, ["Dean", "Shreyas", "Lauchlin"]]
"Nadeem"	[4, ["Ray", "Millar", "Tyler", "Lorenz"]]
"Nader"	[2, ["Blaire", "Rihonn"]]
"Nagib"	[2, ["Ateeq", "Maneet"]]
"Naif"	[2, ["Dilan", "LLeyton"]]
"Nairn"	[2, ["Iagan", "Kyden"]]
"Narvic"	[6, ["Ruben", "Leydon", "Mylo", "Tobie", "Zayne", "Bruin"]]
"Nash"	[1, ["Ola-Oluwa"]]
"Nasser"	[1, ["Sean"]]
"Nassir"	[3, ["Glen", "Rorie", "Codie"]]
"Natan"	[7, ["Reilly", "Sanfur", "Dailey", "Callum", "Farren", "Abdur-Rahman", "Kole"]]
"Nate"	[3, ["Eamon", "Cinar", "Moore"]]
"Nathan"	[5, ["Justan", "J", "Ayren", "Evan", "Nikash"]]
"Nathan-Rae"	[5, ["Ryszard", "Bilal", "Mika", "Oscar", "Doire"]]
"Nathanael"	[4, ["Luc", "Reace", "Sam", "Cairn"]]
"Nathanial"	[3, ["Lance", "Parkash", "Kaylem"]]
"Nathaniel"	[1, ["Zoubaeir"]]
"Nawfal"	[6, ["Ieuan", "Asif", "Malakhy", "Wojciech", "Charles", "Aiman"]]
"Nayan"	[3, ["Rafi", "Tomson", "Jan"]]
"Neco"	[7, ["Kuba", "Oluwadamiloju", "Finnean", "Bendeguz", "Warren", "Meftah", "Kalvin"]]
"Neil"	[4, ["Musa", "Eli", "John", "Brody"]]
"Nelson"	[2, ["Stewarty", "Colm"]]
"Neo"	[6, ["Heyden", "Fergal", "Vince", "Ogheneruno", "Kori", "Macauley"]]
"Neshawn"	[8, ["Brandyn", "Zacharius", "Cobain", "Edison", "Gideon", "Armaan", "Keiron", "Msughter"]]
"Nevan"	[3, ["Umut", "Sonny", "Koddi"]]
"Nevin"	[3, ["Hassan", "Dylan-Patrick", "Abdulkhader"]]
"Ngonidzashe"	[7, ["Cian", "Yorgos", "Mark", "Boyd", "Robertjohn", "Isira", "Gavin-Lee"]]
"Nial"	[5, ["Caie", "Rayan", "Kimi", "Judah", "Ayan"]]
"Niall"	[5, ["Kaydan", "Milos", "Fraser", "Jay-Jay", "Saifaddine"]]
"Nicholas"	[4, ["Tre", "Rio", "Chidera", "Enrique"]]
"Nick"	[2, ["Ralfs", "Lloyde"]]
"Nickhill"	[4, ["Kyel", "Makenzie", "Berkay", "Ricards"]]
"Nicki"	[3, ["Nadeem", "Keo", "Johnson"]]
"Nickson"	[6, ["Conar", "Rubyn", "Amgad", "Findlay", "Mcbride", "Leyton"]]
"Nicky"	[4, ["Kristofer", "Joeddy", "Madaki", "Arron"]]
"Nico"	[5, ["Cody-Lee", "Tieran", "Grady", "Jaheim", "Kelum"]]
"Nicodemus"	[6, ["Stephen", "Bailie", "Reis", "Valo", "Dermot", "Kaidan"]]
"Nicol"	[6, ["Santiago", "Eassan", "Abhinav", "Peni", "Ari", "Dakota"]]
"Nicolae"	[4, ["Rohaan", "Jac", "Zaaine", "Del"]]
"Nicolas"	[4, ["Niki", "Reean", "Harvey", "Abdihakim"]]
"Nidhish"	[5, ["Pasquale", "Tayo", "Kaywan", "Yaseen", "Gabriel"]]
"Nihaal"	[2, ["Niall", "Marco"]]
"Nihal"	[4, ["Tamiem", "Anmolpreet", "Sachkirat", "Loghan"]]
"Nikash"	[3, ["Kyral", "Airen", "Darroch"]]
"Nikhil"	[5, ["Lionel", "Jon-Paul", "Habeeb", "Nate", "Zerah"]]
"Niki"	[4, ["Connall", "Wayde", "Jardine", "Meko"]]
"Nikodem"	[4, ["Zander", "Lewie", "Tjay", "Maximilian"]]
"Nikolai"	[1, ["Kairn"]]
"Nikos"	[4, ["Pierre-Antoine", "Muhammad", "Jincheng", "Keith"]]
"Nilav"	[4, ["Soul", "Ronnie", "Denton", "Babatunmise"]]
"Niraj"	[3, ["Callan-Adam", "Ardeshir", "Daanyaal"]]
"Niro"	[3, ["Keayn", "Robin", "Geoff"]]
"Niven"	[1, ["Rayhan"]]
"Noah"	[5, ["Cory", "Dougal", "Antony", "Kaydin", "Tate"]]
"Noel"	[5, ["Freddie", "Al", "Pablo", "Chintu", "Yago"]]
"Nolan"	[3, ["Atom", "Cadon", "Ryleigh"]]
"Noor"	[1, ["Cesare"]]
"Norman"	[6, ["Shannon", "Ricco", "Jon", "Kerr", "Darrach", "Aiden-Jack"]]
"Norrie"	[5, ["Zeid", "Liam", "Sulayman", "McKade", "Amir"]]
"Nuada"	[4, ["Walid", "Finlay", "Beinn", "Casey"]]
"Nyah"	[5, ["Eiddon", "Brett", "Zakaria", "Graham", "Arsalan"]]
"Oakley"	[7, ["Faysal", "Allesandro", "Rossi", "Derrin", "Steve", "Cohen", "Baillie"]]
"Oban"	[4, ["Dale", "Calvin", "Ebow", "Remo"]]
"Obieluem"	[5, ["Giacomo", "Jacki", "Marvin", "Brandan", "Clayton"]]
"Obosa"	[3, ["Nikolai", "Ezekiel", "Abdul"]]
"Odhran"	[6, ["Cruiz", "Arann", "Tayyib", "Kealon", "Mohamad", "Patrick-John"]]
"Odin"	[5, ["Christopher-Lee", "Isak", "Nickhill", "Daymian", "Yasir"]]
"Odynn"	[6, ["Anselm", "Loki", "Sahaib", "Jayden-Thomas", "Cai", "Corie"]]
"Ogheneochuko"	[2, ["Ilyaas", "Che"]]
"Ogheneruno"	[5, ["Nathanial", "Airlie", "Khevien", "Eng", "Raithin"]]
"Ohran"	[3, ["Ryan-Lee", "Symon", "Connel"]]
"Oilibhear"	[4, ["Darcy", "Oluwatoni", "Hyden", "Seumas"]]
"Oisin"	[2, ["Kenzeigh", "Ruari"]]
"Ojima-Ojo"	[2, ["Bartlomiej", "Maxwell"]]
"Okeoghene"	[5, ["Carlo", "Addisson", "Honey", "Joaquin", "Mackenzy"]]
"Ola-Oluwa"	[2, ["Norman", "Uzayr"]]
"Olaf"	[5, ["Jadyn", "Pietro", "Zack", "Kelam", "Breandan"]]
"Olaoluwapolorimi"	[2, ["Keelan", "Temba"]]
"Ole"	[7, ["Ayman", "Dedeniseoluwa", "Nihaal", "Marlon", "Roderick", "Alex", "Ivar"]]
"Olie"	[3, ["Craig", "Tyra", "Jaz"]]
"Oliver"	[5, ["Fyfe", "Riyadh", "Laison", "Yakup", "Ireayomide"]]
"Olivier"	[3, ["Nevan", "Caedyn", "Sheigh"]]
"Oliwier"	[4, ["Karol", "Bhaaldeen", "Mickey", "Dissanayake"]]
"Ollie"	[3, ["Malachy", "Wilson", "Chaitanya"]]
"Olurotimi"	[4, ["Emerson", "Jamey", "Zen", "Tommi-Lee"]]
"Oluwadamilare"	[6, ["Sung", "Waqaas", "Finn", "Cathal", "Olurotimi", "Ksawery"]]
"Oluwadamiloju"	[2, ["Danyal", "Eimantas"]]
"Oluwafemi"	[6, ["Kailin", "Cole", "Derry", "Grayson", "Matthew-William", "Leroy"]]
"Oluwafikunayomi"	[6, ["Feden", "Savin", "Henry", "Cameron", "Macallum", "Odynn"]]
"Oluwalayomi"	[3, ["Philippos", "Motade", "Leland"]]
"Oluwatobiloba"	[7, ["Alhaji", "Jack-James", "Kacper", "Fabian", "Roman", "Niraj", "Azim"]]
"Oluwatoni"	[3, ["Reese", "Hashem", "Mohammad-Bilal"]]
"Omar"	[5, ["Laughlan", "Aleksandar", "Chu", "Paul", "Garry"]]
"Omri"	[6, ["Caiden-Paul", "Nickson", "Ray", "Harleigh", "Axel", "Eryk"]]
"Oran"	[4, ["Cormack", "Sahil", "Dominik", "Jaydyn"]]
"Orin"	[2, ["Kyron", "Ennis"]]
"Orlando"	[5, ["Lliam", "Kia", "Haider", "Zi", "Andrei"]]
"Orley"	[3, ["Flint", "Riach", "Benoit"]]
"Orran"	[3, ["Kenzo", "John-Paul", "Shadow"]]
"Orrick"	[4, ["Ambanimoh", "Basile", "Rubhan", "Jaksyn"]]
"Orrin"	[4, ["Filippo", "Vrishin", "Aden", "Macsen"]]
"Orson"	[6, ["Rory", "Zain", "Glen", "Jagat", "Lenyn", "Brendan"]]
"Oryn"	[3, ["Mathew", "Alister", "Nuada"]]
"Oscar"	[7, ["Argyle", "Daimhin", "Sanfur", "Lyall", "Keenan", "Brady", "Hcen"]]
"Osesenagha"	[4, ["George", "Peiyan", "Rogan", "Yusuf"]]
"Oskar"	[3, ["Abdallah", "Harrison", "Kit"]]
"Ossian"	[4, ["Jazz", "Lance", "Moayd", "Kaylem"]]
"Oswald"	[4, ["Alber", "Sher", "Irvine", "Marcello"]]
"Otto"	[1, ["Zoubaeir"]]
"Owain"	[2, ["Bill", "Ricky"]]
"Owais"	[4, ["Shaunpaul", "Darrie", "Khai", "Raheem"]]
"Owen"	[5, ["Finnen", "Jan", "Benedict", "Kalvin", "Surien"]]
"Owyn"	[6, ["Musse", "Rhudi", "Arun", "Daood", "Aedin", "Cayden"]]
"Oz"	[6, ["Zakk", "Tiylar", "Kenneth", "Alum", "Levi", "Eli"]]
"Pablo"	[4, ["Keiron", "Damon", "Thomson", "Brandyn"]]
"Pacey"	[3, ["Jacob", "Kadin", "Lennan"]]
"Padraig"	[3, ["Umut", "Jeevan", "Luk"]]
"Paolo"	[6, ["Mohd", "Arda", "Bracken", "Robertjohn", "Tegan", "Laurence"]]
"Pardeepraj"	[5, ["Aleksandrs", "Esteban", "Nicodemus", "Ayan", "Jude"]]
"Parkash"	[4, ["Aarron", "Tarik", "Kaydan", "Saim"]]
"Parker"	[5, ["Shaye", "Oz", "Indy", "Davi", "Akan"]]
"Pascoe"	[1, ["Athos-Carlos"]]
"Pasquale"	[5, ["Orlando", "Flynn", "Michael-James", "Kyhran", "Bernard"]]
"Patrick"	[4, ["Makin", "Jole", "Ash", "Ricards"]]
"Patrick-John"	[4, ["Gurdeep", "Keo", "Conghaile", "Jamal"]]
"Patrikas"	[4, ["Kaleem", "Maddison", "Wabuya", "Rhian"]]
"Patryk"	[2, ["Joeddy", "Grady"]]
"Paul"	[7, ["Mathuyan", "Stephen", "Ross", "Bailie", "Coel", "Jahid", "Kaiden"]]
"Pavit"	[3, ["Calum", "Abhinav", "Lysander"]]
"Pawel"	[4, ["Gerard", "Peni", "Alf", "Rohaan"]]
"Pawlo"	[1, ["Harvey"]]
"Pearce"	[5, ["Duncan", "Abdirahman", "Modoulamin", "Cristian", "Aran"]]
"Pearse"	[3, ["Dawud", "Albie", "Christoph"]]
"Pearsen"	[4, ["Ericlee", "Corey-Jay", "Sachkirat", "Ty-Alexander"]]
"Pedram"	[7, ["Bjorn", "Franciszek", "Charly", "Kyran", "Wylie", "Tamiem", "Mikey"]]
"Pedro"	[2, ["Emmanuel", "Airen"]]
"Peirce"	[3, ["Burak", "Zhen", "Meko"]]
"Peiyan"	[4, ["Oluwalayomi", "Kurtis-Jae", "Benjamyn", "Maias"]]
"Pele"	[3, ["Lewie", "Prithvi", "Eliot"]]
"Peni"	[2, ["Oisin", "Devan"]]
"Peregrine"	[6, ["Dane", "Arnab", "Maciej", "Reuben", "Kris", "Scott-Alexander"]]
"Peter"	[3, ["Zachary-Marc", "Alihaider", "Pierre-Antoine"]]
"Phani"	[3, ["Kodie", "Rehan", "Nolan"]]
"Philip"	[2, ["Daegan", "Lukas"]]
"Philippos"	[3, ["Alessandro", "Aydin", "Issiaka"]]
"Phinehas"	[5, ["Etienne", "Louie", "Cosmo", "Caileb-John", "Aayan"]]
"Phoenix"	[4, ["Mirza", "Yago", "Chintu", "Tate"]]
"Phoevos"	[5, ["Jorryn", "Nelson", "Cadyn", "Shea", "Tristain"]]
"Pierce"	[5, ["Jasper", "Hamzah", "Micheal", "Tait", "Zishan"]]
"Pierre-Antoine"	[4, ["Darrach", "Aiden-Vee", "Rice", "Jon"]]
"Pieter"	[3, ["Kerr", "Raegan", "Brydon"]]
"Pietro"	[4, ["Amir", "Sullivan", "Kruz", "Casper"]]
"Piotr"	[4, ["Danny", "Eidhan", "Madison", "Hubert"]]
"Porter"	[7, ["Jaida", "Precious", "Allesandro", "Rowan", "Matteo", "Leonardo", "Brett"]]
"Prabhjoit"	[5, ["Odhran", "Koray", "Kaidyn", "Hendri", "Remo"]]
"Prabodhan"	[7, ["Keilan", "Jevan", "Morton", "Phani", "Saul", "Thiago", "Ed"]]
"Praise"	[5, ["Nikolai", "Deniss", "Kabir", "Azedine", "Alfred"]]
"Pranav"	[2, ["Reegan", "Abdul"]]
"Pravin"	[2, ["Aled", "Bohbi"]]
"Precious"	[2, ["Harjyot", "Aaren"]]
"Prentice"	[4, ["Dominic", "Sahaib", "Kasper", "Miles"]]
"Presley"	[4, ["Nathanial", "Jordan", "Kyrillos", "Xander"]]
"Preston"	[4, ["Torrin", "Hagun", "Jarno", "Connel"]]
"Preston-Jay"	[3, ["Rhys", "Kyan", "Ceiran"]]
"Prinay"	[5, ["D'arcy", "Kenzi", "Aryankhan", "Eljon", "Johnny"]]
"Prince"	[5, ["Devlin", "Aman", "Lex", "Sudais", "Comghan"]]
"Prithvi"	[2, ["Carlos", "Hong"]]
"Promise"	[1, ["Edwyn"]]
"Puneetpaul"	[6, ["Farhan", "Norman", "Kogan", "Uzayr", "Stanley", "Matej"]]
"Pushkar"	[4, ["Reid", "Jerome", "Dafydd", "Lukmaan"]]
"Qasim"	[3, ["Keelin", "Bradlie", "Deecan"]]
"Qirui"	[6, ["Harrington", "Kirk", "Ayomide", "Simon", "Eugene", "Cain"]]
"Quinlan"	[5, ["Craig", "Fyfe", "Yang", "Drakeo", "Pardeepraj"]]
"Quinn"	[6, ["Riyadh", "Joseph", "Erdehan", "Sheigh", "Alasdair", "Laison"]]
"Radmiras"	[5, ["Lockey", "Kienan", "Zohaib", "Coray", "Angus"]]
"Raees"	[5, ["Chang-Ha", "Aidy", "Taliesin", "Bharath", "Dissanayake"]]
"Raegan"	[4, ["Emerson", "Shaughn", "Nash", "Darrell"]]
"Rafael"	[4, ["Lincoln-John", "Olurotimi", "Conlly", "Ammer"]]
"Rafal"	[2, ["Selasi", "Johansson"]]
"Rafferty"	[3, ["Kendyn", "Colin", "Titi"]]
"Rafi"	[1, ["Renars"]]
"Raheem"	[3, ["Keiran", "Macaulay", "Jez"]]
"Rahil"	[6, ["Dennis", "Clyde", "Kade", "Gianluca", "Roman", "Sonneey"]]
"Rahim"	[4, ["Cullen", "Samir", "Abdulkadir", "Azim"]]
"Rahman"	[4, ["Paul", "Laughlan", "Bowie", "Chukwuemeka"]]
"Raith"	[3, ["Killian", "Isimeli", "Shyam"]]
"Raithin"	[2, ["Lorenzo", "Antoine"]]
"Raja"	[8, ["Kavin", "Chibudom", "Blake", "Manmohan", "Rikki", "Xiao", "A-Jay", "Immanuel"]]
"Rajab-Ali"	[4, ["Rajan", "Nawfal", "Zidane", "Athol"]]
"Rajan"	[4, ["Jarvi", "Wesley-Scott", "Oran", "Florin"]]
"Ralfs"	[5, ["Asa", "Daren", "Makensie", "Kye", "Shae"]]
"Ralph"	[2, ["Mayson", "Rubhan"]]
"Ramanas"	[1, ["Kristin"]]
"Ramit"	[5, ["Brendon", "Macy", "Daniels", "Jody", "Efe"]]
"Ramone"	[4, ["Stefano", "Zaine", "Jago", "Kaid"]]
"Ramsay"	[3, ["Farzad", "Sanjay", "Konan"]]
"Ramsey"	[5, ["Peiyan", "Rogan", "CJ", "Bradyn", "Moosa"]]
"Rana"	[3, ["Alexx", "Ayrton", "Tyrone"]]
"Ranolph"	[5, ["Taylor-Jay", "Jazz", "Drew", "Reagan", "Apisai"]]
"Raphael"	[3, ["Alber", "Marcin", "Roark"]]
"Rasmus"	[4, ["Raphael", "Corey", "Josh", "Avani"]]
"Rasul"	[4, ["Francis", "Bill", "Mikael", "Saad"]]
"Raul"	[5, ["Rico", "Ainsley", "Darrie", "Jonny", "Tony"]]
"Raunaq"	[5, ["Jaosha", "Linden", "Zeph", "Russel", "Connal"]]
"Ravin"	[2, ["Rhy", "Warrick"]]
"Ray"	[6, ["Zakk", "Elias", "Kenneth", "Daood", "Sergei", "Johnathan"]]
"Rayaan"	[4, ["Fergie", "Colt", "Deshawn", "Kainui"]]
"Rayan"	[4, ["Vincent", "Mueez", "Scot", "Jiao"]]
"Rayane"	[7, ["Zachariya", "Coban", "Phoevos", "Brannan", "Thomson", "Gil", "Jacques"]]
"Rayden"	[2, ["Hassanali", "Sorley"]]
"Rayhan"	[4, ["Mohd", "Tegan", "Pawlo", "Dylin"]]
"Raymond"	[7, ["Sidharth", "Aleksandrs", "Gene", "Ciann", "Aydan", "Youcef", "Laurie"]]
"Rayne"	[5, ["Kingston", "Saim", "Loudon", "Aaryan", "Cailaen"]]
"Rayyan"	[4, ["Frazer", "Blazey", "Xue", "Ozzy"]]
"Raza"	[1, ["Neco"]]
"Reace"	[6, ["Jaskaran", "Michal", "Zinedine", "Taegen", "Conor", "Dillon"]]
"Reagan"	[6, ["Aiden", "Will", "Shai", "Kyhran", "Darl", "Bernard"]]
"Reean"	[5, ["Nader", "Ashlee-jay", "Conghaile", "Jole", "Liall"]]
"Reece"	[6, ["Bayley", "Sukhvir", "Ami", "Oliver", "Findlay-James", "Wai"]]
"Reed"	[4, ["Carwyn", "Joel", "Ehsen", "Daniyal"]]
"Reegan"	[6, ["Kelvan", "Zainedin", "Derren", "Ross-Andrew", "Graeme", "Pranav"]]
"Rees"	[4, ["Abhisumant", "Bailley", "Reiss", "Konnor"]]
"Reese"	[5, ["Santino", "Jesuseun", "Peregrine", "Braiden", "Easton"]]
"Reeve"	[4, ["Demetrius", "Clark", "Jace", "Alfee"]]
"Regan"	[1, ["Ubaid"]]
"Regean"	[6, ["Duncan", "Gallagher", "Christoph", "Aldred", "Yasin", "Robbi"]]
"Reggie"	[6, ["Dayem", "Erik", "Avinash", "Cahlum", "Nicholas", "Josiah"]]
"Rehaan"	[3, ["Bjorn", "Kash", "Tammam"]]
"Rehan"	[2, ["Oswald", "Kyran"]]
"Reice"	[5, ["Ryan", "Ata", "Khaya", "Connan", "Emmet"]]
"Reid"	[2, ["Oluwalayomi", "Jared"]]
"Reigan"	[6, ["Daragh", "Afonso", "John-Michael", "Elisau", "Hussnain", "Kenyon"]]
"Reilly"	[3, ["Lewin", "Ruaraidh", "Jak"]]
"Reily"	[4, ["Oisin", "Mack", "Reuben", "Kaison"]]
"Reis"	[4, ["Arnab", "Scott-Alexander", "Edward", "Thrinei"]]
"Reiss"	[2, ["Babur", "Denver"]]
"Remigiusz"	[4, ["Samy", "Calley", "Lukasz", "Kody"]]
"Remo"	[3, ["Ciarian", "Geoffrey", "Pearsen"]]
"Remy"	[7, ["Tymon", "Julien", "Etinosa", "Raymond", "Caileb-John", "Kinsey", "Aydin"]]
"Ren"	[3, ["Douglas", "Taylan", "Jayse"]]
"Renars"	[4, ["Ritchie", "Chiqal", "Attila", "Ioannis"]]
"Reng"	[4, ["Cadyn", "Ryley", "Lochlan-Oliver", "Tristain"]]
"Rennie"	[5, ["Chad", "Orrick", "Dinaras", "Micheal", "Karimas"]]
"Reno"	[3, ["Aiden-Vee", "Sharland", "Brydon"]]
"Reo"	[2, ["Ammaar", "McKauley"]]
"Reuben"	[2, ["Sebastian", "Johann"]]
"Rexford"	[2, ["Tiree", "Colby"]]
"Reynold"	[4, ["Derron", "Baley", "Jaida", "Allister"]]
"Rhein"	[2, ["Abir", "Ed"]]
"Rheo"	[6, ["Gian", "Marwan", "Leiten", "Zachariah", "Rohit", "Branden"]]
"Rhett"	[2, ["Azedine", "Abdul-Aziz"]]
"Rheyden"	[3, ["Patrikas", "Bony", "Lauchlan"]]
"Rhian"	[6, ["Shreeram", "Isher", "Christy", "Robbie-lee", "Marcus", "Nicki"]]
"Rhoan"	[6, ["Caidan", "Kieryn", "Dominick", "Corin", "Sahbian", "Miles"]]
"Rholmark"	[5, ["Kasper", "Ilyas", "Kyro", "Blair", "Xander"]]
"Rhoridh"	[2, ["Shawnpaul", "Torsten"]]
"Rhuairidh"	[4, ["Jarno", "Digby", "Liyonela-Elam", "Meyzhward"]]
"Rhuan"	[4, ["Shaarvin", "D'arcy", "Kyde", "Myles"]]
"Rhuaridh"	[3, ["Guang", "Pushkar", "Ruaridh"]]
"Rhudi"	[5, ["Aman", "Devlyn", "Olaf", "Rhein", "Vladimir"]]
"Rhy"	[4, ["Joash", "Kelan", "Aron", "Hong"]]
"Rhyan"	[4, ["Alistair", "Stanley", "Zackary", "Glascott"]]
"Rhyley"	[2, ["Abdurraheem", "Valen"]]
"Rhyon"	[4, ["Geordie", "Eagann", "Jerome", "Pedro"]]
"Rhys"	[5, ["Jura", "Nihal", "Tyree", "Eugene", "Izaak"]]
"Rhys-Bernard"	[6, ["Mitchell", "Dre", "Craig-James", "Caine", "Aon", "Abbas"]]
"Rhyse"	[5, ["Lakshya", "Davis", "Chris", "Kayleb", "Yang"]]
"Riach"	[8, ["Hao", "Joseph", "Erdehan", "Kienan", "Austen", "Nevin", "Zohair", "Lockey"]]
"Rian"	[4, ["Jay", "Angus", "Windsor", "Bharath"]]
"Ricards"	[5, ["Richie", "Kylian", "Ashwin", "Nash", "Emil"]]
"Riccardo"	[5, ["Zendel", "Lincoln-John", "Rupert", "Conlon", "Ammer"]]
"Ricco"	[5, ["Kalum", "Sunny", "Dhyia", "Ben", "Ksawier"]]
"Rice"	[2, ["Preston", "Murry"]]
"Richard"	[5, ["Alphonse", "Zaki", "Derryn", "Ogheneochuko", "Ruadhan"]]
"Richey"	[2, ["Jia", "Sayad"]]
"Richie"	[2, ["Brandonlee", "Zacharie"]]
"Ricky"	[2, ["Reeve", "Sonni"]]
"Rico"	[5, ["Luic", "Keatin", "Teejay", "Archibald", "Dylan-John"]]
"Ridley"	[5, ["Jubin", "Aleksander", "Isimeli", "Lauren", "Yoolgeun"]]
"Ridwan"	[3, ["Killian", "Rayaan", "Caidyn"]]
"Rihab"	[2, ["Chibudom", "Tanzeel"]]
"Rihan"	[2, ["Kian", "Ajayraj"]]
"Rihards"	[4, ["Rajan", "Dilano", "Lloyd", "Michael-Alexander"]]
"Rihonn"	[5, ["Darien", "Kye", "Karam", "Cejay", "Aiadan"]]
"Rikki"	[3, ["Toby", "Asfhan", "Kenzy"]]
"Riley"	[5, ["Ameer", "Devrin", "Jakub", "Conan", "Rubin"]]
"Rio"	[3, ["Adenn", "Macy", "Arran"]]
"Rioden"	[6, ["Roshan", "Leo", "Zaine", "Glenn", "Aliyaan", "Mathu"]]
"Rishi"	[3, ["Reily", "Callyn", "Konan"]]
"Ritchie"	[2, ["Jerry", "Moray"]]
"Rivan"	[4, ["Lee", "Justin", "CJ", "Alexzander"]]
"Riyadh"	[1, ["Calan"]]
"Riyaj"	[2, ["Yannick", "Christian"]]
"Roan"	[4, ["Isa", "Dawson", "Marcin", "Albert"]]
"Roark"	[5, ["Corey", "Zubair", "Sabeen", "Anish", "Mikee"]]
"Roary"	[1, ["Billy"]]
"Rob"	[4, ["Buddy", "Khalan", "Jonothan", "Zeph"]]
"Robbi"	[3, ["Benjamin", "Russell", "Wasif"]]
"Robbie"	[3, ["Sergei", "Arunas", "Aedyn"]]
"Robbie-lee"	[4, ["Alvern", "Maxim", "Brogan", "Colt"]]
"Robby"	[7, ["Reno", "Ohran", "Vincent", "Adain", "Fergus", "Hirvaansh", "Struan"]]
"Robert"	[4, ["Keiryn", "Dan", "Gil", "Brannan"]]
"Robert-Gordon"	[3, ["Mason-Jay", "Noah", "Denon"]]
"Robertjohn"	[3, ["Momin", "Luka", "Urban"]]
"Robi"	[5, ["Yousif", "Ciar", "Keavan", "Ismail", "Laurie"]]
"Robin"	[5, ["Kinneil", "Ethan", "Aydan", "Rayden", "Cailaen"]]
"Rocco"	[2, ["Ozzy", "Tariq-Jay"]]
"Roddy"	[5, ["Lachlann", "Fred", "Atli", "Chin", "Shayne"]]
"Roderick"	[3, ["Zion", "Ramanas", "Conor"]]
"Rodrigo"	[5, ["Kareem", "Fodeba", "Michal", "Anees", "Orley"]]
"Roen"	[5, ["Elshan", "Maksim", "Aiden", "Nagib", "Shane"]]
"Rogan"	[4, ["Dexter", "Zeeshan", "Conlan", "Kal-el"]]
"Roger"	[4, ["Adil", "Hristomir", "Beau", "Findlie"]]
"Rohaan"	[3, ["Zak", "Joel", "Arryn"]]
"Rohan"	[4, ["Bailley", "Obieluem", "Ross-Andrew", "Derrie"]]
"Rohin"	[6, ["Maanav", "Satveer", "Calum-James", "Remigiusz", "Abhisumant", "Easton"]]
"Rohit"	[3, ["Clarke", "Ghyll", "Kehinde"]]
"Rokas"	[5, ["Ayyub", "Harvie", "Cale", "Lucca", "Ewing"]]
"Roman"	[3, ["Tayyab", "Samatar", "Jean-Pierre"]]
"Ronald"	[3, ["Marcous", "Erik", "Aldred"]]
"Ronan"	[4, ["Harish", "Cahlum", "Tye", "Jayden-Paul"]]
"Ronan-Benedict"	[4, ["Oswald", "Rihab", "Chase", "Ikemsinachukwu"]]
"Ronin"	[4, ["Emmet", "Airidas", "Darryl", "Malo"]]
"Ronnie"	[3, ["Melville", "Lisandro", "Diesel"]]
"Rooke"	[3, ["Ahmad", "Oluwatobiloba", "Ceejay"]]
"Roray"	[3, ["Zane", "Aryan", "Tobey"]]
"Rori"	[5, ["Carl", "Vinnie", "Alyas", "Jake", "Kaiwen"]]
"Rorie"	[5, ["Muhammed", "Danial", "Hogan", "Rexford", "Thrinei"]]
"Rory"	[3, ["Matas", "Spondon", "Pieter"]]
"Roshan"	[6, ["Daegyu", "Abdul-Rehman", "Noor", "Babur", "Lukasz", "Kaelan"]]
"Ross"	[4, ["Areez", "Lawrie", "Geomer", "Bradley"]]
"Ross-Andrew"	[3, ["Tymoteusz", "Silas", "Alessio"]]
"Rossi"	[2, ["Jayson", "Louis"]]
"Rowan"	[4, ["Marc", "Kaydyn", "Rivan", "Blyth"]]
"Rowen"	[4, ["Kiefer", "Aulay", "Josan", "Neo"]]
"Roy"	[3, ["Orrin", "Jaxon", "Karl"]]
"Ruaidhri"	[3, ["Kevan", "Rafael", "James-Paul"]]
"Ruairi"	[7, ["McKay", "Ollie", "Krzysiek", "Bekim", "Hugh", "Finley", "Cassy"]]
"Ruairidh"	[5, ["Murray", "Tiree", "Dante", "Eihli", "Arthur"]]
"Ruan"	[6, ["Balian", "Kaileb", "Rowen", "Grant", "Steven-lee", "Colby"]]
"Ruaraidh"	[3, ["Saunders", "Remy", "Mac"]]
"Ruari"	[4, ["Eddie", "Rokas", "Philip", "Keir"]]
"Ruaridh"	[5, ["Azeem", "Maryk", "Solomon", "Kacey", "Dennan"]]
"Ruben"	[1, ["Keane"]]
"Rubhan"	[1, ["Patryk"]]
"Rubin"	[3, ["Harlee", "Kieryn", "Joynul"]]
"Rubyn"	[4, ["Xavier", "Frankie", "Owais", "Kyro"]]
"Rudi"	[5, ["Chevy", "Enis", "Torsten", "Nathaniel", "Daryl"]]
"Rudy"	[1, ["Haiden"]]
"Rufus"	[6, ["Kamron", "Rhys-Bernard", "Ceirin", "Omri", "I", "Kyde"]]
"Rui"	[6, ["Myles", "Tobias", "Johnpaul", "Guerin", "Kenzie", "Elliot"]]
"Ruo"	[2, ["Olaf", "Kajetan"]]
"Rupert"	[4, ["Kriss", "Seamus", "Vladislav", "Jock"]]
"Ruslan"	[3, ["Zaid", "Lenon", "Glascott"]]
"Russel"	[5, ["Reigan", "Farren", "Stefan", "Badsha", "Derek"]]
"Russell"	[6, ["Teodor", "Moore", "Jeronimo", "Luqman", "Sandy", "Arfin"]]
"Ryaan"	[5, ["Jura", "Layne", "Cillin", "Maros", "Peirce"]]
"Ryan"	[2, ["Caine", "Ayren"]]
"Ryan-Lee"	[2, ["Fyn", "Moad"]]
"Ryden"	[4, ["Josese", "Eren", "Shenuk", "Nevin"]]
"Ryder"	[1, ["Corben"]]
"Ryese"	[7, ["Karson", "Ieuan", "Kylian", "Bilal", "Darren", "Wojciech", "Oryn"]]
"Ryhs"	[4, ["Kez", "Lincon", "Tommy", "Emil"]]
"Rylan"	[3, ["Ruslan", "Conlon", "McLay"]]
"Rylay"	[4, ["Cavan", "Arturo", "John", "Magnus"]]
"Rylee"	[3, ["Kenlin", "Leven", "Ruaidhri"]]
"Ryleigh"	[2, ["Fergal", "Reng"]]
"Ryley"	[3, ["Keiren", "Ediomi", "Msughter"]]
"Rylie"	[3, ["Cobain", "Kaden", "Zacharius"]]
"Ryo"	[5, ["Calib", "Abdulkarem", "Faheem", "Koddi", "Regan"]]
"Ryszard"	[3, ["Cian", "Gavin", "Boyd"]]
"Saad"	[4, ["Eshan", "Aleksander", "Ayaan", "Rayan"]]
"Sabeen"	[7, ["Harley", "Blazej", "Kayam", "Milo", "Aaron-James", "Taonga", "Jayhan"]]
"Sachkirat"	[3, ["Xida", "Lachlainn", "Fraser"]]
"Saffi"	[3, ["Connor", "Kian", "Enrico"]]
"Saghun"	[2, ["Cejay", "Tadhg"]]
"Sahaib"	[3, ["Shahmir", "Nadeem", "Makenzie"]]
"Sahbian"	[3, ["Sukhi", "Jamaal", "Rubin"]]
"Sahil"	[1, ["Findlay"]]
"Saif"	[8, ["Prabodhan", "Gordon", "Ege", "Joe", "Sean-James", "Brendyn", "Kelso", "Zaineddine"]]
"Saifaddine"	[3, ["Valery", "Aliyaan", "Mathu"]]
"Sajid"	[3, ["Alexzander", "Georgy", "Braeden"]]
"Sajjad"	[5, ["Niki", "Harry", "Ewan", "Aytug", "Kiya"]]
"Salahudin"	[4, ["Bodhan", "Jean", "Pascoe", "Samar"]]
"Salman"	[2, ["Sheriff", "Gabriel"]]
"Salter"	[3, ["Jayden-James", "Zubayr", "Eric"]]
"Salvador"	[5, ["Kyral", "Wyatt", "Mikee", "Ridley", "Oskar"]]
"Sam"	[1, ["Emlyn"]]
"Saman"	[3, ["Mehraz", "Sweyn", "Jardine"]]
"Samar"	[4, ["Hussain", "Sergio", "Aeron", "Oluwafikunayomi"]]
"Samarjit"	[3, ["Broghan", "Mustafa", "Kensey"]]
"Samatar"	[3, ["Desmond", "Fergus", "Kairn"]]
"Sambrid"	[4, ["Reo", "Caolain", "Muhamadjavad", "Machlan"]]
"Sameer"	[5, ["Lennex", "Gio", "Brayden", "Keison", "Jad"]]
"Sami"	[1, ["Kadyn"]]
"Sami-Ullah"	[6, ["Jules", "Alekzander", "Ismail", "Lawlyn", "Ciar", "Declan"]]
"Samir"	[2, ["Keayn", "Momin"]]
"Samual"	[4, ["Antonio", "Aaryn", "Mir", "Cory"]]
"Samuel"	[6, ["Ines", "Pablo", "Kaydin", "Yadgor", "Blessing", "Chin"]]
"Samuela"	[5, ["Joris", "Hamza", "Eoghain", "Cadon", "Ramanas"]]
"Samy"	[5, ["Michat", "Tai", "Zion", "Jason", "Karim"]]
"Sanaullah"	[5, ["Jomuel", "Cesar", "Ashley", "Shane", "Aiden-Jack"]]
"Sandro"	[6, ["Rudy", "Nagib", "Gurthar", "Zeeshan", "Toluwalase", "Elvin"]]
"Sandy"	[4, ["Walid", "Kristopher", "Dexter", "Kal-el"]]
"Sanfur"	[1, ["Bret"]]
"Sanjay"	[3, ["Rossi", "Leonardas", "Kaidinn"]]
"Santiago"	[4, ["Satveer", "Dale", "Heini", "Vedantsinh"]]
"Santino"	[3, ["Clarke", "Morris", "Jeswin"]]
"Satveer"	[5, ["Marvellous", "Kabeer", "Exodi", "Klein", "Sohan"]]
"Saul"	[2, ["Samatar", "Reed"]]
"Saunders"	[3, ["Robbie", "Gareth", "Bogdan"]]
"Savin"	[5, ["Nick", "Avraham", "Harjeevan", "Loki", "Shiloh"]]
"Sayad"	[3, ["Jayden-Thomas", "Tanay", "Cori"]]
"Sayeed"	[2, ["Joojo", "Che"]]
"Sayf"	[3, ["Connar", "Eng", "Ryan-Lee"]]
"Scot"	[7, ["Benn", "Hussnan", "Kyaan", "Diesel", "Kamil", "Rhyon", "Wei"]]
"Scott"	[6, ["Puneetpaul", "Maison", "Johnnie", "Muzzammil", "Brooklin", "Sethu"]]
"Scott-Alexander"	[4, ["Colvin", "Griffyn", "Subhaan", "Jake"]]
"Seaan"	[3, ["Addison", "Vinnie", "Ojima-Ojo"]]
"Seamas"	[5, ["Braydyn", "Muhsin", "Edwin", "Zack", "Kelam"]]
"Seamus"	[6, ["Matas", "Denzel", "Noor", "Bader", "Spondon", "Jadon"]]
"Sean"	[4, ["Dyllon", "Areez", "Sanaullah", "Temba"]]
"Sean-James"	[1, ["Aazaan"]]
"Sean-Paul"	[4, ["Kaydyn", "Salman", "Yakup", "Laird"]]
"Sean-Ray"	[6, ["Marc", "Sheafan", "Alan", "Chiron", "Tristan", "Eonan"]]
"Seane"	[5, ["Ivan", "Dedeniseoluwa", "Pedram", "Yuanyu", "Lawrie"]]
"Seb"	[6, ["Dion", "Ramsay", "Lock", "Copeland", "Jaxon", "Caedan"]]
"Sebastian"	[3, ["Richard", "Bhaaldeen", "Talha"]]
"Sebastien"	[3, ["Narvic", "Emanuel", "Zen"]]
"Selasi"	[5, ["McKay", "Ollie", "James-Paul", "Ruo", "Kallan"]]
"Seonaidh"	[4, ["Arthur", "Madox", "Dante", "Hugo"]]
"Sephiroth"	[8, ["Brian", "Ally", "Grant", "Eihli", "Kenan", "Tisloh", "Zakary", "Lepeng"]]
"Sergei"	[6, ["Kailin", "Henry", "Ren", "Steven-lee", "Matthew", "Odin"]]
"Sergio"	[1, ["Jeyun"]]
"Seth"	[5, ["Dennin", "Jack-James", "Leithen", "Solomon", "Giancarlo"]]
"Sethu"	[3, ["Calen", "Nilav", "Kobi"]]
"Seumas"	[4, ["Mohammad", "Yoji", "Patryk", "Lauchlin"]]
"Shaarvin"	[8, ["Shreyas", "Mario", "Awwal", "Kile", "Nickson", "Caiden", "Aleem", "Eroni"]]
"Shadow"	[3, ["Jaydon", "Cormac", "Dominik"]]
"Shae"	[4, ["Ajay", "Daryl", "Owais", "Chevy"]]
"Shahmir"	[5, ["Rajab-Ali", "Khizer", "Enis", "Byron", "LLeyton"]]
"Shai"	[4, ["Ryder", "Omri", "Tadd", "Wesley"]]
"Shane"	[1, ["Elliot"]]
"Shannon"	[2, ["Zayne", "Ruben"]]
"Sharland"	[3, ["Filippo", "Hope", "Carrich"]]
"Sharoz"	[5, ["Kellan", "Tiarnan", "Daniel-James", "Sean", "Macsen"]]
"Shaughn"	[3, ["Zaid", "Kai", "Codie"]]
"Shaun"	[5, ["Dailey", "Jeronimo", "Luqman", "Farren", "Callum"]]
"Shaun-Paul"	[5, ["Justan", "Evan", "Marshall", "Alexei", "Tyrnan"]]
"Shaun-Thomas"	[7, ["Abdallah", "Moad", "Taylor", "Jazib", "Bob", "Kaylem", "Crawford"]]
"Shaunpaul"	[4, ["Layton", "J", "Moore", "Roen"]]
"Shaurya"	[4, ["Davy", "Roan", "Marcello", "Parkash"]]
"Shaw"	[3, ["Rana", "Corbin", "Hareem"]]
"Shawn"	[3, ["Doire", "Kym", "Karsyn"]]
"Shawnpaul"	[3, ["Kez", "Tomson", "Emile"]]
"Shay"	[5, ["Zenith", "Rafi", "Diarmaid", "Conlyn", "Meftah"]]
"Shayaan"	[7, ["Kuba", "Finnean", "Bendeguz", "Warren", "Danys", "Aedin", "Kalvin"]]
"Shayan"	[6, ["Kenlin", "Preston-Jay", "Musa", "Gregor", "Brody", "Eli"]]
"Shaye"	[6, ["Fergal", "Ruaidhri", "Barkley", "Ogheneruno", "Stewarty", "Max"]]
"Shayne"	[2, ["Campbell", "Jian"]]
"Shazil"	[5, ["Cobain", "Gideon", "Keiron", "Lennan", "Phoenix"]]
"Shea"	[5, ["Denny", "Faheem", "Sonny", "Hassan", "Calin"]]
"Sheafan"	[1, ["Sami-Ullah"]]
"Sheigh"	[2, ["Isira", "Decklan"]]
"Shenuk"	[5, ["Tyllor", "Anton", "Harman", "Kimi", "Jay-Jay"]]
"Sher"	[6, ["Inan", "Oz", "Kaydan", "Blazej", "Taonga", "Chidera"]]
"Shergo"	[6, ["Daumantas", "Shaye", "Enrique", "Nayan", "Athos-Carlos", "Cade"]]
"Sheriff"	[1, ["Andrew"]]
"Sherwyn"	[2, ["Flyn", "Celik"]]
"Shiloh"	[3, ["Gurdeep", "Ash", "Ellisandro"]]
"Shiraz"	[2, ["Sukhpal", "Baye"]]
"Shreeram"	[4, ["Munir", "Rheyden", "Madaki", "Ehsan"]]
"Shreyas"	[5, ["Stephen", "Gordon", "Dermot", "Allan", "Brendyn"]]
"Shyam"	[4, ["Konar", "Calum", "Lyndsay", "Valo"]]
"Siddhant"	[4, ["Peni", "Ari", "Jesse", "Braeden"]]
"Siddharth"	[6, ["Ayub", "Marty", "Del", "Ewen", "Jac", "C-Jay"]]
"Sidharth"	[5, ["Jean-Lewis", "Kiyonari", "Tyson", "Samar", "Arafat"]]
"Sidney"	[5, ["Pasquale", "Bodhan", "Yaseen", "Kayne", "Isaa"]]
"Siergiej"	[5, ["Dawud", "Haris", "Rasmus", "Niall", "Marco"]]
"Silas"	[4, ["Tamiem", "Ossian", "Domanic", "Corey-James"]]
"Simon"	[4, ["Ijay", "Jon-Paul", "Charly", "Kyral"]]
"Sinai"	[5, ["Khaleel", "Nate", "Jardine", "Zerah", "Rahim"]]
"Skye"	[7, ["Amrit", "Kameron", "Syed", "Benjamyn", "Cayden-Tiamo", "Mehraz", "Oluwafikunayomi"]]
"Sofian"	[5, ["Johnjay", "Darach", "Mahmoud", "Tjay", "Hussan"]]
"Sohaib"	[4, ["Greig", "Prithvi", "Alvin", "Colton"]]
"Sohail"	[3, ["Caolan", "Danar", "Oilibhear"]]
"Soham"	[6, ["Lennex", "Gio", "Keison", "Jincheng", "Armen", "Pierre-Antoine"]]
"Sohan"	[6, ["Kodie", "Uri", "Babatunmise", "Alihaider", "Soul", "Ronnie"]]
"Sol"	[6, ["Ardeshir", "Dyllan", "Havila", "Teiyib", "Callan", "Rehaan"]]
"Solomon"	[3, ["Keayn", "Markus", "Lawlyn"]]
"Sonneey"	[4, ["Ayden", "Aaryn", "Cailean", "Rayhan"]]
"Sonni"	[4, ["Cory", "Yago", "Kaydin", "Mir"]]
"Sonny"	[4, ["Atom", "Lael", "Nelson", "Eoghain"]]
"Sorley"	[2, ["Cadon", "Michat"]]
"Soul"	[3, ["Folarinwa", "Cesare", "Dimitri"]]
"Spencer"	[6, ["Darn", "Jon", "Maksymilian", "Gurthar", "Kern", "Naif"]]
"Spondon"	[5, ["Rudy", "Beinn", "Sulayman", "Dhani", "Jameil"]]
"Stanislaw"	[6, ["Madison", "Seb", "Walid", "Finlay", "Casey", "Arsalan"]]
"Stanley"	[3, ["Brett", "Pravin", "Zakaria"]]
"Stefan"	[2, ["Kaidyn", "Matt"]]
"Stefano"	[6, ["Dale", "Thiago", "Maaz", "Brandan", "Ebow", "Arihant"]]
"Stefin"	[7, ["Zach", "Giacomo", "Kabir", "Marvin", "Leilan", "Rohin", "Alfie"]]
"Stephen"	[2, ["Harvinder", "Calean"]]
"Stephenjunior"	[3, ["Dustin", "Mohamad", "Christopher-Lee"]]
"Steve"	[5, ["Avraham", "Robbie", "Isak", "Alec", "Jostelle"]]
"Steven"	[4, ["Loki", "Cai", "Raunaq", "Mikolaj"]]
"Steven-lee"	[7, ["Blaine", "Che", "Rihan", "Otto", "Ma'moon", "Kasim", "Tanay"]]
"Stevie"	[4, ["Eng", "Zhong", "Atal", "Butali"]]
"Stewart"	[5, ["Ryan-Lee", "Litrell", "Firaaz", "Diesil", "Jarl"]]
"Stewarty"	[4, ["Darcy", "Johnnie", "Seumas", "Hussnan"]]
"Strachan"	[5, ["Kenzeigh", "Tobi", "Ruari", "Zarran", "Lewis"]]
"Struan"	[6, ["Fiachra", "Carlo", "Devlin", "Reynold", "Honey", "Subhaan"]]
"Stuart"	[4, ["Muhsin", "Breandan", "Addisson", "Pietro"]]
"Su"	[8, ["Gjan", "Jadyn", "Roray", "Stanislaw", "Denzel", "Zack", "Bader", "Matej"]]
"Subhaan"	[4, ["Jeremy", "Reid", "Haydn", "Luke"]]
"Sudais"	[6, ["Montgomery", "Pedram", "Yuanyu", "Keelan", "Temba", "Aref"]]
"Suheyb"	[6, ["Ayman", "Nihaal", "Marlon", "Jun", "Simon", "Euan"]]
"Suilven"	[5, ["Loukas", "Craig", "Jaz", "Rayne", "Taylar"]]
"Sukhi"	[5, ["Sheigh", "Laison", "Yakup", "Alanas", "Ireayomide"]]
"Sukhpal"	[5, ["Aun", "Caedyn", "Troy", "Neshawn", "Josef"]]
"Sukhvir"	[5, ["Kyle-Derek", "Rylie", "Angelo", "Wilson", "Talha"]]
"Sulayman"	[6, ["Idris", "Richey", "Jonatan", "Aidy", "Narvic", "Darrel"]]
"Sullivan"	[4, ["Gus", "Jamey", "Ruo", "Zen"]]
"Sultan"	[3, ["Krzysztof", "Believe", "Finn"]]
"Sung"	[5, ["Kendall", "Johannes", "Danyal", "Zakary", "Eimantas"]]
"Sunny"	[3, ["Ally", "Feden", "Matthew-William"]]
"Suraj"	[3, ["Motade", "Ren", "Victory"]]
"Surien"	[4, ["Alhaji", "Roman", "Clifford", "Leland"]]
"Sweyn"	[4, ["Dennin", "Fabian", "Nilav", "Marzuq"]]
"Syed"	[3, ["Cullen", "Sami", "Jedidiah"]]
"Sylvain"	[4, ["Dean", "Axel", "Robert", "Ishwar"]]
"Symon"	[4, ["Lorenz", "Sahil", "Nickson", "Jaydyn"]]
"Szymon"	[3, ["Tanvir", "Dominik", "Miller"]]
"T-Jay"	[4, ["Sandro", "Aref", "Pedro", "Lukmaan"]]
"TJ"	[2, ["Lenny", "Edwyn"]]
"Tadd"	[6, ["Shay", "Kia", "Byron", "Nathan-Rae", "Athol", "Daryn"]]
"Taddy"	[4, ["Andrei", "Conner", "Michael", "Lliam"]]
"Tadhg"	[2, ["Ceiron", "Ahtasham"]]
"Taegan"	[2, ["Mylo", "Elliott"]]
"Taegen"	[4, ["Mayson", "Ambanimoh", "Rubhan", "Ola-Oluwa"]]
"Tai"	[5, ["Hopkin", "Kristian", "Sean", "Jody", "Carrick"]]
"Tait"	[1, ["Kellen"]]
"Taiwo"	[10, ["Reilly", "Derick", "Nuada", "Valentin", "Hcen", "Bailee", "Kai", "Farzad", "Stefano", "Callun"]]
"Talha"	[5, ["Eamon", "Lyall", "Keenan", "Moosa", "George"]]
"Taliesin"	[4, ["Alexx", "Skye", "J", "Nikash"]]
"Talon"	[3, ["Crawford", "Sam", "Tyrnan"]]
"Talorcan"	[7, ["Taylor-Jay", "Lance", "Chrismedi", "Parker", "Dregan", "Roan", "Moayd"]]
"Tamar"	[3, ["Ranolph", "Dawid", "Austin"]]
"Tamiem"	[1, ["Anis"]]
"Tammam"	[6, ["Kym", "Ricky", "Jonny", "Francesco", "Igor", "Aiman"]]
"Tanay"	[2, ["Tomson", "Raheem"]]
"Tane"	[3, ["Oluwadamiloju", "Jan", "Surien"]]
"Tanner"	[5, ["Musse", "Danys", "Johnathan", "Eli", "Mahan"]]
"Tanvir"	[3, ["Stewarty", "Gregor", "Jaime"]]
"Tanzeel"	[6, ["Barney", "Hiro", "Fergie", "Damon", "Korrin", "Rennie"]]
"Taonga"	[4, ["Phoevos", "Edison", "Armaan", "Lennan"]]
"Tarik"	[4, ["Jacob", "Niven", "Azlan", "Kadin"]]
"Tariq-Jay"	[6, ["Regean", "Samual", "Jeevan", "Dylan-Patrick", "Curtis", "Abdulkhader"]]
"Tate"	[4, ["Mark", "Keaton", "Ciann", "Youcef"]]
"Taylan"	[3, ["Aarron", "Caie", "Siddharth"]]
"Taylar"	[7, ["Antoni", "Oz", "Milos", "Saim", "Tarik", "Donnie", "Jay-Jay"]]
"Tayler"	[6, ["Lachlan", "Indy", "Rio", "Manson", "Athos-Carlos", "Akan"]]
"Taylor"	[5, ["Ralph", "Andy", "Zinedine", "Jasim", "Hamid"]]
"Taylor-Jay"	[4, ["Kyhran", "Orlando", "Dillon", "Bernard"]]
"Taylor-Lee"	[8, ["Makin", "Nader", "Johnson", "Aidan", "Radmiras", "Keo", "Shai", "Bryan"]]
"Tayo"	[5, ["Baye", "Dex", "Ami", "Conghaile", "Gurdeep"]]
"Tayyab"	[3, ["Adie", "Olie", "Sean-Paul"]]
"Tayye"	[7, ["Breogan", "Praise", "Coel", "Ehsan", "Arron", "Munmair", "Grady"]]
"Tayyib"	[5, ["Calum", "Konnor", "Valo", "Allan", "Mathuyan"]]
"Te-Jay"	[1, ["Darroch"]]
"Teagan"	[4, ["Reiss", "Lyndsay", "Keeton", "Aria"]]
"Tee"	[4, ["Rohaan", "Leigham", "Martyn", "Del"]]
"Tee-jay"	[4, ["Modoulamin", "Boedyn", "Tayo", "Aran"]]
"Teighen"	[4, ["Haris", "Jayden-Lee", "Zuriel", "Cahl"]]
"Teiyib"	[3, ["Airen", "Kash", "Wylie"]]
"Temba"	[7, ["Amrit", "Lionel", "Diego", "Syed", "Zhen", "Connan", "Ryaan"]]
"Teo"	[5, ["Johnjay", "Darach", "Afonso", "Kurtis-Jae", "Arya"]]
"Teodor"	[6, ["Griffin", "Kenton", "Jak", "Ruan", "Zander", "T-Jay"]]
"Teos"	[4, ["Ferre", "Oisin", "Reuben", "Koushik"]]
"Terry"	[4, ["Muhammad", "Dane", "Thorfinn", "Hishaam"]]
"Teydren"	[5, ["Alihaider", "Cobi", "Spencer", "Ronnie", "Kaeden"]]
"Theo"	[7, ["Kodie", "Babatunmise", "Usman", "Havila", "Abdulmalik", "Daegan", "Nolan"]]
"Theodore"	[5, ["Pearse", "Areeb", "Bradan", "Lawrence", "Geoffrey"]]
"Thiago"	[6, ["Julian", "Tymon", "Etienne", "Siergiej", "Alessandro", "Rocco"]]
"Thierry"	[5, ["Cosmo", "Haroon", "Rayhan", "Caileb-John", "Jayse"]]
"Thom"	[6, ["Freddie", "Kaydn", "Pacey", "David-Jay", "Ala", "Ritchie"]]
"Thomas"	[3, ["Eoghan", "Nelson", "Zishan"]]
"Thomas-Jay"	[5, ["Orrick", "Bevin", "Ryleigh", "Tait", "Folarinwa"]]
"Thomson"	[4, ["Idahosa", "Elyan", "Rice", "Sharland"]]
"Thorben"	[3, ["Amir", "Rufus", "James"]]
"Thorfinn"	[4, ["Casper", "Kalen", "Oliwier", "Kruz"]]
"Thrinei"	[1, ["Madison"]]
"Thumbiko"	[5, ["Jai", "Kaidyn", "Rowan", "Derrin", "Zakaria"]]
"Tiago"	[4, ["Maaz", "Abir", "Faysal", "Saul"]]
"Tian"	[7, ["Keilan", "Zach", "Jacki", "Morton", "Leiten", "Thiago", "Rohit"]]
"Tiarnan"	[6, ["Nikolai", "Deniss", "Marvin", "Azedine", "Klevis", "Uilleam"]]
"Tibet"	[3, ["Tayyib", "Cruz", "Kean"]]
"Tieran"	[3, ["Isak", "Garren", "Latif"]]
"Tiernan"	[3, ["Ernie-Jacks", "Kieron", "Corie"]]
"Timothy"	[5, ["Jaydn", "Owain", "Xander", "Kasim", "Miles"]]
"Timucin"	[2, ["Nathanial", "Eniola"]]
"Tiree"	[3, ["Raithin", "Hagun", "Diesil"]]
"Tisloh"	[2, ["Oluwatoni", "Kamran"]]
"Titi"	[3, ["Zayd", "Tobi", "D'arcy"]]
"Titus"	[4, ["Fikret", "Jakey", "Bartosz", "Kajally"]]
"Tiylar"	[4, ["Vithujan", "Joash", "Addisson", "Daniele"]]
"Tjay"	[4, ["Haydon", "Norman", "Deon", "Matej"]]
"Tobey"	[3, ["Ivar", "Roderick", "Marlon"]]
"Tobi"	[3, ["Lovell", "Cain", "Nihaal"]]
"Tobias"	[2, ["Drakeo", "Tayler"]]
"Tobie"	[3, ["Erdehan", "Troy", "Sheigh"]]
"Toby"	[5, ["Lockey", "Hansen", "Taliesin", "Zohaib", "Coray"]]
"Todd"	[4, ["Shaughn", "Orson", "Kyle-Derek", "Aidy"]]
"Tokinaga"	[7, ["Emerson", "Lincoln", "Gus", "Kevyn", "Jonathan", "Tommi-Lee", "Nash"]]
"Toluwalase"	[3, ["Dhyia", "Ksawery", "Kallin"]]
"Tom"	[4, ["Danyal", "Mael", "Titi", "Cator"]]
"Tomas"	[3, ["Grayson", "Preston", "Roy"]]
"Tomasz"	[6, ["Victory", "Felix", "Stevie", "Kain", "Abu", "Odynn"]]
"Tommi-Lee"	[4, ["Arjuna", "Thomas", "Jez", "Gianluca"]]
"Tommy"	[5, ["Niraj", "Jackson", "Azim", "Marzuq", "Leland"]]
"Tomson"	[4, ["Archibald", "Abdulkadir", "Samir", "Caley"]]
"Torin"	[5, ["Rayaan", "Tyler-James", "Deano", "Caiden-Paul", "Killian"]]
"Torquil"	[6, ["Kavin", "Aaron", "Blake", "Lorenz", "Donald", "Cormack"]]
"Torran"	[4, ["Daryn", "Manmohan", "Immanuel", "Chi"]]
"Torrin"	[3, ["Jarvi", "Kia", "Lliam"]]
"Torsten"	[1, ["Oran"]]
"Trafford"	[2, ["Elliott", "Shae"]]
"Trai"	[8, ["Qirui", "Guillaume", "Suilven", "Ze", "Leyland", "Ambanimoh", "Conan", "Rubhan"]]
"Travis"	[5, ["Daniels", "Macy", "Rhett", "Kale", "Olaoluwapolorimi"]]
"Tre"	[4, ["Tibet", "Glenn", "Prabhjoit", "Lenyn"]]
"Trent"	[7, ["Rory", "Nyah", "Jago", "Valentino", "Alister", "Kaid", "Farzad"]]
"Trey"	[4, ["Hcen", "Sanjay", "Eamonn", "Konan"]]
"Tristain"	[4, ["Lee", "Alexx", "Bradyn", "Jaay"]]
"Tristan"	[2, ["Nikhil", "Justin"]]
"Troy"	[4, ["Fynn", "Parker", "Drew", "Sam"]]
"Tubagus"	[4, ["Alber", "Chrismedi", "Lancelot", "Isa"]]
"Turki"	[6, ["Corey", "Hari", "Ranolph", "Saad", "Kieran", "Erencem"]]
"Turner"	[4, ["Kynan", "Osesenagha", "Karthikeya", "Woyenbrakemi"]]
"Ty"	[6, ["Nassir", "Shaun-Paul", "Khai", "Tony", "Emir", "Asim"]]
"Ty-Alexander"	[6, ["Linden", "Guy", "Amos", "Zennon", "Connal", "Surien"]]
"Tye"	[5, ["Kurt", "Finnen", "Rhy", "Aedyn", "Husnain"]]
"Tyelor"	[4, ["Elias", "Kenneth", "Tiylar", "Levon"]]
"Tylar"	[3, ["Maxim", "Ohran", "Kainui"]]
"Tyler"	[4, ["Keiryn", "Eduardo", "Mueez", "Sayf"]]
"Tyler-James"	[3, ["Aliekber", "Sorley", "Brandyn"]]
"Tyler-Jay"	[3, ["Regean", "Luk", "Kadin"]]
"Tyllor"	[5, ["Pawlo", "Dylin", "Bracken", "Tegan", "Youcef"]]
"Tylor"	[4, ["Marko", "Sidharth", "Robi", "Ismaeel"]]
"Tymom"	[3, ["Rayane", "Saim", "Jayke"]]
"Tymon"	[3, ["Frazer", "Akram", "Ozzy"]]
"Tymoteusz"	[3, ["Ralph", "Atli", "Hamish"]]
"Tyra"	[4, ["Karandeep", "Flynn", "Rylay", "Bernard"]]
"Tyree"	[5, ["Makin", "Nader", "Ashlee-jay", "Will", "Darl"]]
"Tyrnan"	[3, ["Elshan", "Conghaile", "Gursees"]]
"Tyrone"	[3, ["Kaleem", "Wai", "Rhian"]]
"Tyson"	[3, ["Adil", "Kelvan", "Sean-Paul"]]
"Ubaid"	[3, ["Kaiden", "Derren", "Allan-Laiton"]]
"Ubayd"	[5, ["Reiss", "Santino", "Konnor", "Calum-James", "Lysander"]]
"Uchenna"	[5, ["Eassan", "Kehinde", "Aria", "Peregrine", "Braiden"]]
"Uilleam"	[4, ["Nikita", "Kjae", "Jace", "Ayyub"]]
"Umair"	[3, ["Cale", "Harvie", "Jean-Pierre"]]
"Umar"	[1, ["Isaac"]]
"Umer"	[4, ["Harish", "Erik", "Lokesh", "Rasul"]]
"Umut"	[1, ["Jayden-Lee"]]
"Urban"	[4, ["Emmet", "Airidas", "Ikechukwu", "Ridwan"]]
"Uri"	[4, ["Amro", "Rahman", "Ryan", "Lisandro"]]
"Usman"	[6, ["Kames", "Afonso", "Ceejay", "Sylvain", "Hussnain", "Fintan"]]
"Uzair"	[8, ["Daragh", "Griffin", "Brooke", "Seth", "Arya", "Muzammil", "T-Jay", "Kenyon"]]
"Uzayr"	[2, ["Lewie", "Kaison"]]
"Valen"	[2, ["Arnab", "Fezaan"]]
"Valentin"	[6, ["Muhammed", "Pieter", "Lennon", "Girijan", "Edward", "Keith"]]
"Valentino"	[9, ["Kody", "Callan-Adam", "Usman", "Alisdair", "Rehan", "Masson", "Fares", "Denver", "Nolan"]]
"Valery"	[2, ["Jenson", "Hayden"]]
"Valo"	[4, ["Ciarian", "Declyn", "Rocco", "Siergiej"]]
"Vasyl"	[4, ["Haroon", "Aydin", "Raymond", "Cosmo"]]
"Vedantsinh"	[5, ["Chiqal", "Kaydn", "Mirza", "Lagan", "Frederick"]]
"Veeran"	[4, ["Shea", "Ala", "Josan", "Neo"]]
"Victor"	[2, ["Lochlann", "Ryley"]]
"Victory"	[5, ["Chad", "Karimas", "Bezalel", "Malachai", "Aiden-Vee"]]
"Vinay"	[3, ["Gurveer", "Tomas", "Sharland"]]
"Vince"	[3, ["Ammaar", "Finley", "Sullivan"]]
"Vincent"	[2, ["Sebastian", "Artem"]]
"Vincenzo"	[3, ["Matteo", "Rowan", "Ken"]]
"Vinh"	[3, ["Cambell", "Veeran", "Hendri"]]
"Vinnie"	[3, ["Aristomenis", "Saunders", "Dalong"]]
"Vithujan"	[2, ["Azedine", "Zachariah"]]
"Vladimir"	[3, ["Jed", "Luciano", "Aray"]]
"Vladislav"	[5, ["Isher", "Kean", "Lauchlan", "Robbie-lee", "Bony"]]
"Vrishin"	[6, ["Tylar", "Joynul", "Deacon", "Aled", "Awais", "Kieron"]]
"Vuyolwethu"	[2, ["Jaydn", "Miles"]]
"Wabuya"	[7, ["Shawnpaul", "AJ", "Owain", "Ilyas", "Frankie", "Kyro", "Xander"]]
"Wai"	[3, ["Atapattu", "Raithin", "Zhuo"]]
"Walid"	[1, ["Ryden"]]
"Wallace"	[3, ["Tobias", "Aryian", "D'arcy"]]
"Walter"	[7, ["Guang", "Maxx", "Devlyn", "Kenzi", "Jakob", "Zayd", "Conal"]]
"Waqaas"	[4, ["Sudais", "Fikret", "Carlos", "Bartosz"]]
"Warkhas"	[5, ["Zackary", "Glascott", "Muir", "Piotr", "Tiago"]]
"Warren"	[4, ["Codi", "Leno", "Rori", "Norrie"]]
"Warrick"	[4, ["Haydon", "Valen", "Jerome", "Kogan"]]
"Wasif"	[4, ["Rodrigo", "Layne", "Yuri", "Bradly"]]
"Wayde"	[6, ["Harrington", "Sinai", "Kirk", "Rayyan", "Tyree", "Eugene"]]
"Wayne"	[4, ["Jazeb", "Craig-James", "Boab", "Lovell"]]
"Wei"	[4, ["Davis", "Chris", "Marcel", "Riyaj"]]
"Wen"	[6, ["Hao", "Corben", "Kienan", "Jay", "Lockey", "Cael"]]
"Wesley"	[6, ["Richie", "Forrest", "Miguel", "Taliesin", "Angus", "Oryn"]]
"Wesley-Scott"	[4, ["Ashwin", "Nash", "Iestyn", "Ailin"]]
"Wiktor"	[4, ["Jamie", "Lincoln-John", "Ammer", "Rafferty"]]
"Wilkie"	[4, ["Aedan", "Selasi", "Ksawery", "Cator"]]
"Will"	[1, ["Greg"]]
"William"	[5, ["Alphonse", "Stewart", "Ogheneochuko", "Vinay", "Ruadhan"]]
"William-John"	[6, ["Renars", "Thomas", "Arjuna", "Ediomi", "Sayad", "Jia"]]
"Willum"	[2, ["Lenin", "Ronald"]]
"Wilson"	[5, ["Calib", "Luic", "Sonni", "Reeve", "Fahad"]]
"Windsor"	[6, ["Pavit", "Bowie", "Keatin", "Mohammed", "Gary", "Jeemie"]]
"Wojciech"	[6, ["Deano", "Eshan", "Ayaan", "Aleksander", "Chukwuemeka", "Jubin"]]
"Woyenbrakemi"	[4, ["Aaron", "Killian", "Antoine", "Milo"]]
"Wyatt"	[3, ["Xida", "Kayam", "Ajayraj"]]
"Wylie"	[3, ["Manmohan", "Nawfal", "Cabhan"]]
"Wynn"	[4, ["Lloyd", "Zidane", "Tadhg", "Connolly"]]
"Xabier"	[3, ["Asa", "Shae", "Wiktor"]]
"Xander"	[3, ["Ellis", "Bruno", "Rubin"]]
"Xavier"	[4, ["Kale", "Devrin", "Olaoluwapolorimi", "Vuyolwethu"]]
"Xiao"	[6, ["Mungo", "Macy", "Daniil", "Seane", "Tibet", "Joe"]]
"Xida"	[2, ["Cody", "Derin"]]
"Xin"	[2, ["Callyn", "Daimhin"]]
"Xue"	[3, ["Terry", "Sanjay", "Pele"]]
"Yadgor"	[2, ["Nikhil", "Tyrone"]]
"Yago"	[3, ["Apisai", "Reagan", "Abdalroof"]]
"Yahya"	[4, ["Fynn", "Kaylum", "Bobby-Lee", "Isa"]]
"Yakup"	[2, ["Joshiah", "Raphael"]]
"Yang"	[2, ["Logan-Rhys", "Anish"]]
"Yanick"	[3, ["Ihtisham", "Jonothan", "Ainsley"]]
"Yann"	[7, ["Jaosha", "Zeph", "Buddy", "Rahil", "Emir", "Linton", "Connal"]]
"Yannick"	[3, ["Diarmuid", "Finnlay", "Hussain"]]
"Yaseen"	[1, ["Arunas"]]
"Yasin"	[6, ["Alvern", "Colt", "Maxim", "Kainui", "Baron", "Desmond"]]
"Yasir"	[4, ["Reno", "Ohran", "Dan", "Scot"]]
"Yassin"	[5, ["Thorben", "Brannan", "Gil", "Eduardo", "Coben"]]
"Yoji"	[3, ["Jacques", "Kodi", "Faizaan"]]
"Yong"	[7, ["Dylin", "Hassanali", "Keavan", "Luka", "Ardal", "Jeffrey", "Cyrus"]]
"Yoolgeun"	[6, ["Aleksandrs", "Laurie", "Ciar", "Brad", "Ismail", "Gene"]]
"Yorgos"	[5, ["Kinneil", "Nicol", "Jules", "Harnek", "Loui"]]
"Youcef"	[5, ["Lachlann", "Xue", "Jayke", "Tariq-Jay", "Milosz"]]
"Yousif"	[4, ["Joris", "Trent", "Davi", "Enzo"]]
"Youssef"	[7, ["Jaskaran", "Michal", "Caden", "Rylee", "Ramanas", "Conor", "Zion"]]
"Yu"	[4, ["Kareem", "Will", "Ibrahim", "Aiden"]]
"Yuanyu"	[4, ["Elshan", "Shane", "Nagib", "Ashlee-jay"]]
"Yuri"	[2, ["McCaulley", "Jameel"]]
"Yusef"	[6, ["Adil", "Rhoan", "Arryn", "Kristopher", "Joel", "Wai"]]
"Yusuf"	[3, ["Zak", "Bret", "Ross-Andrew"]]
"Yves"	[4, ["Bailley", "Mati", "Remigiusz", "Kaidinn"]]
"Zaaine"	[1, ["Theodore"]]
"Zaak"	[5, ["Ghyll", "Marvellous", "Demetrius", "Jack", "Soham"]]
"Zac"	[5, ["Abdisalam", "Harvie", "Nikodem", "Crombie", "Reed"]]
"Zach"	[3, ["Christoph", "Modu", "Yasin"]]
"Zacharias"	[5, ["Domhnall", "Raul", "Tammam", "Mikhail", "Anndra"]]
"Zacharie"	[5, ["Bjorn", "Kashif", "Franco", "Chase", "Wynn"]]
"Zacharius"	[3, ["Nathanael", "Jonson", "Lisandro"]]
"Zachariya"	[6, ["Connar", "Benji", "Ryan", "Amro", "Wayne", "Melville"]]
"Zachary"	[1, ["Hussnain"]]
"Zachary-Marc"	[6, ["Promise", "Tobey", "Colvin", "Jake", "Griffyn", "Kenyon"]]
"Zachery"	[3, ["Su", "Carl", "Kris"]]
"Zack"	[4, ["Keivlin", "Braydyn", "Muhammed", "Thrinei"]]
"Zackary"	[6, ["Kael", "Cobie", "Zachery", "Lennox", "Rooke", "Jadon"]]
"Zaid"	[5, ["Samy", "Kody", "Jensyn", "Lukasz", "Fares"]]
"Zain"	[6, ["Yu", "Lawrie", "Te-Jay", "Keegan", "Pearsen", "Issiaka"]]
"Zaine"	[4, ["Marlin", "Silas", "Aydon", "Tymoteusz"]]
"Zaineddine"	[5, ["Antonyo", "Salahudin", "Dougray", "Aazaan", "Mitch"]]
"Zainedin"	[5, ["Yahya", "Padraig", "Manus", "Laird", "Frederick"]]
"Zak"	[5, ["Ziya", "Ryley", "Lochlan-Oliver", "Tristan", "Caedan"]]
"Zakaria"	[5, ["Dinaras", "Willum", "Kylar", "Jaxon", "Forbes"]]
"Zakariya"	[7, ["Ashton-Lloyd", "Aidian", "Jonah", "Nairn", "Kevan", "Malachai", "Idrees"]]
"Zaki"	[4, ["Madison-Jake", "Rhoridh", "Krzysiek", "Dante"]]
"Zakir"	[4, ["Sebastian", "Grant", "Eihli", "Lepeng"]]
"Zakk"	[4, ["Victor", "Balian", "Odhran", "Allister"]]
"Zamaar"	[4, ["Eddie", "Aristomenis", "Remy", "Moshy"]]
"Zander"	[3, ["Leithen", "Clement", "Gian"]]
"Zane"	[3, ["Solomon", "Dennan", "Haseeb"]]
"Zarran"	[6, ["Sameer", "Aray", "Cuillin", "Teagan", "Lucien", "Dylan"]]
"Zayd"	[5, ["Shreeram", "Yoji", "Awwal", "Joynul", "Marcus"]]
"Zayn"	[5, ["Corin", "Aarez", "Lorcan", "Ravin", "Eroni"]]
"Zayne"	[2, ["Anthony", "Rihards"]]
"Ze"	[4, ["Nathaniel", "Daryl", "Manas", "Torsten"]]
"Zechariah"	[5, ["Ryder", "Tadd", "Digby", "Micah", "Raja"]]
"Zeek"	[3, ["Benny", "Maitlind", "Dareh"]]
"Zeeshan"	[1, ["Guang"]]
"Zeid"	[3, ["Amani", "Basher", "Kajetan"]]
"Zein"	[3, ["Munachi", "Rhein", "Adegbola"]]
"Zen"	[6, ["Glascott", "Jae", "Porter", "Brehme", "Alistar", "Leno"]]
"Zendel"	[6, ["Reigan", "Valen", "Kohen", "Farren", "Callum", "Kaelum"]]
"Zenith"	[4, ["Sandy", "Eagann", "Teodor", "Dagon"]]
"Zennon"	[2, ["Jura", "Layne"]]
"Zeph"	[5, ["Moad", "Caine", "Harris", "Raza", "Salvador"]]
"Zerah"	[2, ["Chris-Daniel", "Pardeepraj"]]
"Zhen"	[7, ["Hao", "Rana", "Tubagus", "Nevin", "Eren", "Shenuk", "Cael"]]
"Zhi"	[4, ["Ryszard", "Anir", "Dmitri", "Oryn"]]
"Zhong"	[3, ["Fox", "Ashwin", "Darren"]]
"Zhuo"	[3, ["Zenith", "Rafi", "Brynmor"]]
"Zi"	[5, ["Kalum", "Finnean", "Diarmaid", "Bendeguz", "McLay"]]
"Zidane"	[1, ["Titus"]]
"Zijie"	[5, ["Altyiab", "Stewart", "Leven", "Zakir", "Ruadhan"]]
"Zinedine"	[5, ["Fergal", "Heyden", "Ogheneochuko", "Macauley", "Reng"]]
"Zion"	[4, ["Cobain", "Jia", "Msughter", "Phinehas"]]
"Zishan"	[4, ["Niro", "Ronald", "Sonni", "Al-Hassan"]]
"Ziya"	[5, ["Mohammed", "Luis", "Tee-jay", "Jeemie", "Archie"]]
"Ziyaan"	[4, ["Pavit", "Isira", "Boyd", "Decklan"]]
"Zohaib"	[3, ["Siddhant", "Lorenzo", "Aaron-James"]]
"Zohair"	[2, ["Donnacha", "Anton"]]
"Zoubaeir"	[4, ["Jordyn", "Daud", "Manolo", "Enrico"]]
"Zubair"	[3, ["Jasey-Jay", "Kian", "Travis"]]
"Zubayr"	[5, ["Kyel", "Flyn", "Cejay", "Dillan", "Karamvir"]]
"Zuriel"	[2, ["Brunon", "Todd"]]
